"Zone Code","Zone Name","ks0010001","ks0010002","ks0010003","ks0010004","ks0010005","ks0010006"
"00AAFA","Aldersgate",1600,860,740,1530,70,17
"00AAFE","Bishopsgate",106,63,43,104,3,0
"00AAFQ","Cripplegate",3007,1499,1508,2863,144,26
"00AAFS","Farringdon Within",181,125,56,131,50,3
"00AAFT","Farringdon Without",687,425,262,644,43,8
"00AAFX","Portsoken",1073,550,523,1073,0,6
"00AAFY","Queenhithe",282,172,110,274,8,4
"00AAFZ","Tower",141,76,65,141,0,0
"00AAGB","Walbrook",108,62,46,101,7,3
"00ABFX","Abbey",10206,5142,5064,10204,3,64
"00ABFY","Alibon",9300,4395,4905,9300,0,9
"00ABFZ","Becontree",11450,5500,5950,11035,415,29
"00ABGA","Chadwell Heath",9299,4317,4982,9279,20,32
"00ABGB","Eastbrook",10096,4773,5323,9869,227,36
"00ABGC","Eastbury",10089,4730,5359,10032,57,38
"00ABGD","Gascoigne",9371,4431,4940,9230,141,38
"00ABGE","Goresbrook",10333,4986,5347,10242,91,23
"00ABGF","Heath",9649,4478,5171,9592,57,30
"00ABGG","Longbridge",8890,4292,4598,8872,18,51
"00ABGH","Mayesbrook",9316,4335,4981,9286,30,15
"00ABGJ","Parsloes",9039,4239,4800,9039,0,19
"00ABGK","River",10260,5014,5246,10186,74,32
"00ABGL","Thames",8547,4034,4513,8497,50,31
"00ABGM","Valence",8775,4061,4714,8775,0,13
"00ABGN","Village",9720,4675,5045,9681,39,30
"00ABGP","Whalebone",9604,4666,4938,9598,6,38
"00ACFX","Brunswick Park",14668,7093,7575,14552,116,185
"00ACFY","Burnt Oak",15243,7168,8075,15201,42,121
"00ACFZ","Childs Hill",17261,8130,9131,16658,603,332
"00ACGA","Colindale",13860,6555,7305,13775,85,151
"00ACGB","Coppetts",14504,6973,7531,14314,190,156
"00ACGC","East Barnet",15332,7459,7873,15287,45,155
"00ACGD","East Finchley",14534,6747,7787,14352,182,153
"00ACGE","Edgware",14816,7081,7735,14784,32,295
"00ACGF","Finchley Church End",13810,6642,7168,13676,134,275
"00ACGG","Garden Suburb",14727,6802,7925,14500,227,387
"00ACGH","Golders Green",16249,7741,8508,16046,203,384
"00ACGJ","Hale",15663,7486,8177,15553,110,221
"00ACGK","Hendon",15377,7390,7987,15124,253,236
"00ACGL","High Barnet",13847,6611,7236,13623,224,243
"00ACGM","Mill Hill",15379,7337,8042,14773,606,282
"00ACGN","Oakleigh",14740,7069,7671,14518,222,248
"00ACGP","Totteridge",14449,6928,7521,14205,244,303
"00ACGQ","Underhill",15721,7324,8397,15469,252,178
"00ACGR","West Finchley",14264,6747,7517,14053,211,198
"00ACGS","West Hendon",14587,6982,7605,14496,91,167
"00ACGT","Woodhouse",15533,7516,8017,15296,237,174
"00ADGA","Barnehurst",10277,4972,5305,10269,8,69
"00ADGB","Belvedere",10839,5151,5688,10839,0,58
"00ADGC","Blackfen and Lamorbey",10419,5084,5335,10415,4,76
"00ADGD","Blendon and Penhill",10418,5056,5362,10418,0,77
"00ADGE","Brampton",10387,5025,5362,10387,0,83
"00ADGF","Christchurch",10390,5013,5377,10250,140,92
"00ADGG","Colyers",10595,5063,5532,10516,79,55
"00ADGH","Crayford",10290,4949,5341,10271,19,36
"00ADGJ","Cray Meadows",10295,4825,5470,10263,32,66
"00ADGK","Danson Park",10315,5001,5314,10278,37,60
"00ADGL","East Wickham",10383,4974,5409,10335,48,66
"00ADGM","Erith",9811,4762,5049,9781,30,47
"00ADGN","Falconwood and Welling",10535,5129,5406,10535,0,68
"00ADGP","Lesnes Abbey",10947,5211,5736,10902,45,90
"00ADGQ","Longlands",9611,4480,5131,9388,223,90
"00ADGR","North End",10465,5068,5397,10465,0,32
"00ADGS","Northumberland Heath",10482,5085,5397,10473,9,72
"00ADGT","St Mary's",10043,4906,5137,9971,72,129
"00ADGU","St Michael's",10672,5250,5422,10672,0,78
"00ADGW","Sidcup",10432,4948,5484,10207,225,113
"00ADGX","Thamesmead East",10701,5196,5505,10627,74,48
"00AEGJ","Alperton",12323,6182,6141,12304,19,110
"00AEGK","Barnhill",13188,6236,6952,12898,290,196
"00AEGL","Brondesbury Park",11643,5610,6033,11518,125,157
"00AEGM","Dollis Hill",12102,5887,6215,12102,0,113
"00AEGN","Dudden Hill",13350,6501,6849,13331,19,123
"00AEGP","Fryent",11888,5845,6043,11863,25,106
"00AEGQ","Harlesden",12227,5715,6512,12206,21,79
"00AEGR","Kensal Green",10668,5123,5545,10637,31,67
"00AEGS","Kenton",11872,5802,6070,11833,39,253
"00AEGT","Kilburn",14172,6684,7488,14092,80,65
"00AEGU","Mapesbury",13242,6545,6697,13128,114,95
"00AEGW","Northwick Park",12175,5915,6260,11449,726,187
"00AEGX","Preston",12832,6307,6525,12764,68,168
"00AEGY","Queens Park",12400,6032,6368,12379,21,103
"00AEGZ","Queensbury",13175,6419,6756,13073,102,152
"00AEHA","Stonebridge",15943,7554,8389,15842,101,102
"00AEHB","Sudbury",12307,5965,6342,12196,111,122
"00AEHC","Tokyngton",11836,5885,5951,11728,108,127
"00AEHD","Welsh Harp",12405,5994,6411,12374,31,109
"00AEHE","Wembley Central",11002,5461,5541,10991,11,126
"00AEHF","Willesden Green",12714,6144,6570,12524,190,80
"00AFGD","Bickley",13904,6531,7373,13444,460,244
"00AFGE","Biggin Hill",10131,5054,5077,10131,0,124
"00AFGF","Bromley Common and Keston",14171,6790,7381,14162,9,109
"00AFGG","Bromley Town",14499,7028,7471,14410,89,175
"00AFGH","Chelsfield and Pratts Bottom",14068,6799,7269,14009,59,175
"00AFGJ","Chislehurst",14739,7009,7730,13968,771,201
"00AFGK","Clock House",15757,7705,8052,15721,36,126
"00AFGL","Copers Cope",14229,6810,7419,14056,173,156
"00AFGM","Cray Valley East",14663,7000,7663,14631,32,66
"00AFGN","Cray Valley West",16121,7635,8486,16066,55,89
"00AFGP","Crystal Palace",11233,5272,5961,11020,213,51
"00AFGQ","Darwin",4704,2345,2359,4694,10,79
"00AFGR","Farnborough and Crofton",14180,6746,7434,14106,74,199
"00AFGS","Hayes and Coney Hall",14923,7202,7721,14694,229,209
"00AFGT","Kelsey and Eden Park",14751,7083,7668,14630,121,176
"00AFGU","Mottingham and Chislehurst North",10114,4750,5364,10077,37,56
"00AFGW","Orpington",15078,7320,7758,14998,80,150
"00AFGX","Penge and Cator",16687,7918,8769,16605,82,125
"00AFGY","Petts Wood and Knoll",13627,6593,7034,13588,39,235
"00AFGZ","Plaistow and Sundridge",14374,6890,7484,14226,148,143
"00AFHA","Shortlands",9303,4446,4857,9295,8,201
"00AFHB","West Wickham",14276,6859,7417,14198,78,225
"00AGGD","Belsize",11653,5617,6036,11522,131,125
"00AGGE","Bloomsbury",9224,4486,4738,6741,2483,38
"00AGGF","Camden Town with Primrose Hill",11574,5817,5757,11080,494,110
"00AGGG","Cantelowes",10490,5078,5412,10009,481,80
"00AGGH","Fortune Green",10465,4944,5521,10350,115,117
"00AGGJ","Frognal and Fitzjohns",11632,5590,6042,10776,856,186
"00AGGK","Gospel Oak",10465,4946,5519,10420,45,89
"00AGGL","Hampstead Town",10617,5046,5571,10102,515,157
"00AGGM","Haverstock",11224,5268,5956,11123,101,77
"00AGGN","Highgate",10492,4760,5732,10409,83,157
"00AGGP","Holborn and Covent Garden",10645,5358,5287,10014,631,46
"00AGGQ","Kentish Town",11462,5526,5936,11294,168,81
"00AGGR","Kilburn",10494,5020,5474,10239,255,74
"00AGGS","King's Cross",11413,5770,5643,9088,2325,44
"00AGGT","Regent's Park",11964,5865,6099,11541,423,70
"00AGGU","St Pancras and Somers Town",12490,5960,6530,12394,96,37
"00AGGW","Swiss Cottage",11663,5465,6198,11597,66,96
"00AGGX","West Hampstead",10053,4882,5171,10025,28,70
"00AHGE","Addiscombe",15402,7507,7895,15299,103,68
"00AHGF","Ashburton",13560,6536,7024,13507,53,157
"00AHGG","Bensham Manor",16088,7772,8316,15937,151,98
"00AHGH","Broad Green",14866,7123,7743,14807,59,80
"00AHGJ","Coulsdon East",12225,5876,6349,12149,76,192
"00AHGK","Coulsdon West",13220,6538,6682,12953,267,242
"00AHGL","Croham",14443,7055,7388,14183,260,204
"00AHGM","Fairfield",14085,7067,7018,13612,473,141
"00AHGN","Fieldway",11176,5177,5999,11168,8,38
"00AHGP","Heathfield",13053,6338,6715,13015,38,203
"00AHGQ","Kenley",13525,6590,6935,13189,336,188
"00AHGR","New Addington",10351,4886,5465,10336,15,39
"00AHGS","Norbury",13812,6591,7221,13758,54,166
"00AHGT","Purley",12998,6329,6669,12774,224,256
"00AHGU","Sanderstead",12165,5798,6367,12139,26,220
"00AHGW","Selhurst",14591,6943,7648,14545,46,65
"00AHGX","Selsdon and Ballards",11879,5815,6064,11731,148,214
"00AHGY","Shirley",13978,6595,7383,13978,0,179
"00AHGZ","South Norwood",14590,6987,7603,14460,130,90
"00AHHA","Thornton Heath",14784,6923,7861,14700,84,123
"00AHHB","Upper Norwood",14190,6837,7353,14107,83,123
"00AHHC","Waddon",13393,6319,7074,13130,263,92
"00AHHD","West Thornton",16498,7939,8559,16301,197,137
"00AHHE","Woodside",15715,7570,8145,15694,21,69
"00AJGC","Acton Central",13442,6632,6810,13171,271,101
"00AJGD","Cleveland",14179,6834,7345,14037,142,213
"00AJGE","Dormers Wells",13073,6381,6692,13010,63,124
"00AJGF","Ealing Broadway",12634,6189,6445,12315,319,187
"00AJGG","Ealing Common",12804,6221,6583,12491,313,136
"00AJGH","East Acton",14448,7005,7443,14421,27,128
"00AJGJ","Elthorne",12328,5819,6509,12229,99,74
"00AJGK","Greenford Broadway",13297,6402,6895,13268,29,100
"00AJGL","Greenford Green",12466,6136,6330,12416,50,110
"00AJGM","Hanger Hill",14010,7038,6972,13930,80,184
"00AJGN","Hobbayne",13068,6260,6808,13050,18,111
"00AJGP","Lady Margaret",12806,6395,6411,12693,113,166
"00AJGQ","Northfield",12477,6158,6319,12468,9,127
"00AJGR","North Greenford",13089,6419,6670,13089,0,138
"00AJGS","Northolt Mandeville",12888,6078,6810,12847,41,80
"00AJGT","Northolt West End",13420,6509,6911,13299,121,76
"00AJGU","Norwood Green",12647,6230,6417,12004,643,126
"00AJGW","Perivale",13441,6724,6717,13426,15,129
"00AJGX","South Acton",13318,6467,6851,13272,46,104
"00AJGY","Southall Broadway",13049,6774,6275,12909,140,131
"00AJGZ","Southall Green",12895,6626,6269,12877,18,119
"00AJHA","Southfield",12481,6064,6417,12476,5,143
"00AJHB","Walpole",12688,6202,6486,12571,117,144
"00AKGL","Bowes",11678,5673,6005,11637,41,109
"00AKGM","Bush Hill Park",13346,6452,6894,13203,143,163
"00AKGN","Chase",12531,5900,6631,12423,108,80
"00AKGP","Cockfosters",12536,5847,6689,12172,364,192
"00AKGQ","Edmonton Green",15103,7074,8029,15099,4,75
"00AKGR","Enfield Highway",14137,6843,7294,14133,4,70
"00AKGS","Enfield Lock",12714,6108,6606,12687,27,68
"00AKGT","Grange",11605,5578,6027,11461,144,170
"00AKGU","Haselbury",14485,6964,7521,14406,79,111
"00AKGW","Highlands",12305,5890,6415,11838,467,153
"00AKGX","Jubilee",13052,6330,6722,12929,123,80
"00AKGY","Lower Edmonton",12686,6002,6684,12686,0,73
"00AKGZ","Palmers Green",13197,6388,6809,13137,60,123
"00AKHA","Ponders End",12978,6149,6829,12390,588,64
"00AKHB","Southbury",12466,6026,6440,12399,67,51
"00AKHC","Southgate",12103,5677,6426,11907,196,159
"00AKHD","Southgate Green",12897,6284,6613,12710,187,231
"00AKHE","Town",13928,6610,7318,13820,108,137
"00AKHF","Turkey Street",12744,6123,6621,12662,82,52
"00AKHG","Upper Edmonton",14843,6940,7903,14590,253,99
"00AKHH","Winchmore Hill",12225,5848,6377,12025,200,164
"00ALGP","Abbey Wood",13372,6352,7020,13273,99,62
"00ALGQ","Blackheath Westcombe",11981,5810,6171,11782,199,170
"00ALGR","Charlton",12608,5944,6664,12492,116,70
"00ALGS","Coldharbour and New Eltham",12425,6020,6405,12311,114,89
"00ALGT","Eltham North",12303,5971,6332,12298,5,101
"00ALGU","Eltham South",11629,5316,6313,11607,22,74
"00ALGW","Eltham West",13438,6365,7073,13397,41,75
"00ALGX","Glyndon",13879,6616,7263,13730,149,53
"00ALGY","Greenwich West",11228,5402,5826,10983,245,99
"00ALGZ","Kidbrooke with Hornfair",12098,5836,6262,12053,45,75
"00ALHA","Middle Park and Sutcliffe",12832,6048,6784,12728,104,95
"00ALHB","Peninsula",10155,4836,5319,10155,0,42
"00ALHC","Plumstead",14112,6761,7351,14089,23,78
"00ALHD","Shooters Hill",12854,6194,6660,12772,82,101
"00ALHE","Thamesmead Moorings",11755,5977,5778,11280,475,63
"00ALHF","Woolwich Common",14967,7153,7814,14147,820,102
"00ALHG","Woolwich Riverside",12767,6176,6591,12695,72,68
"00AMGA","Brownswood",11331,5439,5892,11239,92,61
"00AMGB","Cazenove",10500,5103,5397,10489,11,100
"00AMGC","Chatham",10728,5080,5648,10682,46,48
"00AMGD","Clissold",10438,4939,5499,10438,0,50
"00AMGE","Dalston",10358,5015,5343,10214,144,53
"00AMGF","De Beauvoir",9928,4820,5108,9860,68,70
"00AMGG","Hackney Central",10291,5013,5278,10256,35,52
"00AMGH","Hackney Downs",10276,4831,5445,10212,64,53
"00AMGJ","Haggerston",10366,4985,5381,10182,184,55
"00AMGK","Hoxton",10698,5166,5532,10659,39,50
"00AMGL","King's Park",10964,5173,5791,10961,3,46
"00AMGM","Leabridge",9857,4691,5166,9828,29,57
"00AMGN","Lordship",11299,5392,5907,11194,105,135
"00AMGP","New River",11504,5581,5923,11492,12,147
"00AMGQ","Queensbridge",10179,4915,5264,10152,27,54
"00AMGR","Springfield",10859,5252,5607,10828,31,176
"00AMGS","Stoke Newington Central",10133,4817,5316,10125,8,55
"00AMGT","Victoria",12066,5648,6418,11690,376,47
"00AMGU","Wick",11049,5143,5906,10714,335,57
"00ANGA","Addison",11185,5357,5828,11031,154,114
"00ANGB","Askew",11886,5811,6075,11589,297,45
"00ANGC","Avonmore and Brook Green",11522,5520,6002,11306,216,97
"00ANGD","College Park and Old Oak",7643,3702,3941,7229,414,34
"00ANGE","Fulham Broadway",10189,4892,5297,10189,0,74
"00ANGF","Fulham Reach",10197,4796,5401,10154,43,47
"00ANGG","Hammersmith Broadway",11560,5577,5983,11381,179,78
"00ANGH","Munster",9884,4647,5237,9832,52,94
"00ANGJ","North End",10904,5391,5513,10871,33,51
"00ANGK","Palace Riverside",7333,3387,3946,7316,17,202
"00ANGL","Parsons Green and Walham",10280,4804,5476,10279,0,248
"00ANGM","Ravenscourt Park",10791,5253,5538,10365,426,155
"00ANGN","Sands End",9723,4538,5185,9701,22,93
"00ANGP","Shepherd's Bush Green",10249,5035,5214,10106,143,60
"00ANGQ","Town",9899,4606,5293,9865,34,96
"00ANGR","Wormholt and White City",11997,5677,6320,11970,27,70
"00APGA","Alexandra",10475,4976,5499,10378,97,173
"00APGB","Bounds Green",10905,5085,5820,10826,79,67
"00APGC","Bruce Grove",11997,5823,6174,11923,74,76
"00APGD","Crouch End",10762,5158,5604,10718,44,109
"00APGE","Fortis Green",11235,5348,5887,10882,353,170
"00APGF","Harringay",10525,5219,5306,10515,10,71
"00APGG","Highgate",10310,4973,5337,10098,212,153
"00APGH","Hornsey",10075,4725,5350,10063,12,98
"00APGJ","Muswell Hill",9975,4783,5192,9883,92,204
"00APGK","Noel Park",11472,5420,6052,11279,193,68
"00APGL","Northumberland Park",12606,6008,6598,12429,177,68
"00APGM","St Ann's",12603,6218,6385,12176,427,79
"00APGN","Seven Sisters",13179,6458,6721,13172,7,154
"00APGP","Stroud Green",10324,5091,5233,10280,44,77
"00APGQ","Tottenham Green",11966,5618,6348,11953,13,63
"00APGR","Tottenham Hale",12728,6117,6611,12716,12,71
"00APGS","West Green",11884,5755,6129,11854,30,71
"00APGT","White Hart Lane",11985,5454,6531,11771,214,67
"00APGU","Woodside",11501,5437,6064,11461,40,92
"00AQFY","Belmont",9506,4622,4884,9506,0,172
"00AQFZ","Canons",10091,4704,5387,9891,200,210
"00AQGA","Edgware",9832,4896,4936,9830,3,130
"00AQGB","Greenhill",9324,4419,4905,9118,206,117
"00AQGC","Harrow on the Hill",10632,5385,5247,10405,227,144
"00AQGD","Harrow Weald",10345,4893,5452,10116,229,154
"00AQGE","Hatch End",10098,4739,5359,9925,173,245
"00AQGF","Headstone North",9522,4625,4897,9514,8,195
"00AQGG","Headstone South",9366,4604,4762,9334,32,121
"00AQGH","Kenton East",9888,4773,5115,9888,0,131
"00AQGJ","Kenton West",10277,5057,5220,10234,43,170
"00AQGK","Marlborough",9207,4450,4757,9123,84,100
"00AQGL","Pinner",9601,4472,5129,9517,84,219
"00AQGM","Pinner South",9555,4609,4946,9535,20,221
"00AQGN","Queensbury",10055,4872,5183,10001,54,120
"00AQGP","Rayners Lane",10038,4958,5080,10022,16,155
"00AQGQ","Roxbourne",10947,5277,5670,10918,29,96
"00AQGR","Roxeth",10538,5148,5390,10516,22,97
"00AQGS","Stanmore Park",9339,4397,4942,9159,180,177
"00AQGT","Wealdstone",8963,4347,4616,8857,106,79
"00AQGU","West Harrow",9690,4706,4984,9690,0,130
"00ARGC","Brooklands",13024,6392,6632,12907,117,52
"00ARGD","Cranham",12242,5855,6387,12224,18,139
"00ARGE","Elm Park",12048,5722,6326,12048,0,49
"00ARGF","Emerson Park",11396,5573,5823,11372,24,124
"00ARGG","Gooshays",13991,6570,7421,13880,111,27
"00ARGH","Hacton",12494,6079,6415,12224,270,107
"00ARGJ","Harold Wood",12004,5722,6282,11836,168,67
"00ARGK","Havering Park",12366,5915,6451,12263,103,61
"00ARGL","Heaton",11778,5537,6241,11709,69,30
"00ARGM","Hylands",12380,6055,6325,12338,42,96
"00ARGN","Mawneys",12556,6007,6549,12511,45,62
"00ARGP","Pettits",12831,6221,6610,12761,70,109
"00ARGQ","Rainham and Wennington",12114,5868,6246,12078,36,49
"00ARGR","Romford Town",13200,6427,6773,13038,162,84
"00ARGS","St Andrew's",12778,6079,6699,12655,123,76
"00ARGT","South Hornchurch",12592,6130,6462,12575,17,37
"00ARGU","Squirrel's Heath",11780,5699,6081,11707,73,103
"00ARGW","Upminster",12674,6106,6568,12442,232,208
"00ASGG","Barnhill",11728,5700,6028,11697,31,103
"00ASGH","Botwell",12432,6111,6321,12294,138,86
"00ASGJ","Brunel",10631,5154,5477,9847,784,49
"00ASGK","Cavendish",11239,5404,5835,11232,7,95
"00ASGL","Charville",11429,5638,5791,11331,98,65
"00ASGM","Eastcote and East Ruislip",11480,5548,5932,11343,137,176
"00ASGN","Harefield",7090,3388,3702,6906,184,45
"00ASGP","Heathrow Villages",10217,5059,5158,9958,259,51
"00ASGQ","Hillingdon East",11878,5767,6111,11778,100,85
"00ASGR","Ickenham",9933,4852,5081,9880,53,178
"00ASGS","Manor",10902,5268,5634,10865,37,88
"00ASGT","Northwood",10559,4873,5686,10069,490,215
"00ASGU","Northwood Hills",10833,5007,5826,10809,24,157
"00ASGW","Pinkwell",12346,6032,6314,12323,23,90
"00ASGX","South Ruislip",10823,5233,5590,10617,206,78
"00ASGY","Townfield",11626,5567,6059,11541,85,77
"00ASGZ","Uxbridge North",11671,5690,5981,11382,289,140
"00ASHA","Uxbridge South",11438,5629,5809,10459,979,73
"00ASHB","West Drayton",11589,5602,5987,11422,167,69
"00ASHC","West Ruislip",10183,4855,5328,10068,115,117
"00ASHD","Yeading",11923,5711,6212,11909,14,95
"00ASHE","Yiewsley",11056,5373,5683,11047,9,34
"00ATFY","Bedfont",10104,4962,5142,10091,13,58
"00ATFZ","Brentford",10745,5177,5568,10706,39,60
"00ATGA","Chiswick Homefields",10290,4942,5348,10117,173,163
"00ATGB","Chiswick Riverside",10935,5422,5513,10925,10,191
"00ATGC","Cranford",10936,5530,5406,10935,0,117
"00ATGD","Feltham North",9570,4737,4833,9524,46,59
"00ATGE","Feltham West",11530,5755,5775,11271,259,46
"00ATGF","Hanworth",10995,5290,5705,10976,19,68
"00ATGG","Hanworth Park",10396,5098,5298,10351,45,59
"00ATGH","Heston Central",10998,5466,5532,10868,130,137
"00ATGJ","Heston East",10781,5311,5470,10781,0,149
"00ATGK","Heston West",11332,5568,5764,11275,57,121
"00ATGL","Hounslow Central",10791,5330,5461,10769,22,103
"00ATGM","Hounslow Heath",11115,5452,5663,11105,10,107
"00ATGN","Hounslow South",10369,5091,5278,10363,6,122
"00ATGP","Hounslow West",10356,5330,5026,9955,401,124
"00ATGQ","Isleworth",10745,5034,5711,10563,182,76
"00ATGR","Osterley and Spring Grove",10452,5241,5211,10256,196,162
"00ATGS","Syon",9717,4664,5053,9595,122,55
"00ATGT","Turnham Green",10184,4839,5345,10093,91,143
"00AUFX","Barnsbury",10274,4906,5368,10230,44,87
"00AUFY","Bunhill",10055,4977,5078,9851,204,59
"00AUFZ","Caledonian",11566,5937,5629,11022,544,68
"00AUGA","Canonbury",9899,4664,5235,9899,0,50
"00AUGB","Clerkenwell",9773,4693,5080,8908,865,61
"00AUGC","Finsbury Park",12448,6001,6447,12348,100,64
"00AUGD","Highbury East",10278,4980,5298,10177,101,86
"00AUGE","Highbury West",11681,5625,6056,11661,20,71
"00AUGF","Hillrise",11382,5318,6064,11317,65,82
"00AUGG","Holloway",11214,5282,5932,10630,584,54
"00AUGH","Junction",10816,4969,5847,10562,254,67
"00AUGJ","Mildmay",11339,5375,5964,11331,8,57
"00AUGK","St George's",11178,5257,5921,10729,449,111
"00AUGL","St Mary's",10499,5009,5490,10488,11,72
"00AUGM","St Peter's",10933,5391,5542,10708,225,67
"00AUGN","Tollington",12462,5845,6617,12401,61,66
"00AWFY","Abingdon",9053,4303,4750,8762,291,171
"00AWFZ","Brompton",9313,4299,5014,8843,470,151
"00AWGA","Campden",8173,3947,4226,8115,58,137
"00AWGB","Colville",7909,3739,4170,7894,15,54
"00AWGC","Courtfield",9578,4803,4775,8820,758,103
"00AWGD","Cremorne",9290,4476,4814,9239,51,96
"00AWGE","Earl's Court",9659,4856,4803,9434,225,54
"00AWGF","Golborne",8849,4307,4542,8779,70,37
"00AWGG","Hans Town",9335,4321,5014,9334,0,131
"00AWGH","Holland",9372,4412,4960,9348,24,201
"00AWGJ","Norland",8778,4191,4587,8715,63,213
"00AWGK","Notting Barns",9000,4281,4719,9000,0,55
"00AWGL","Pembridge",8116,3856,4260,8007,109,113
"00AWGM","Queen's Gate",9668,4597,5071,9333,335,157
"00AWGN","Redcliffe",8625,4089,4536,8430,195,127
"00AWGP","Royal Hospital",7662,3740,3922,7271,391,185
"00AWGQ","St Charles",9010,4288,4722,8889,121,57
"00AWGR","Stanley",7529,3454,4075,7222,307,195
"00AXFX","Alexandra",9045,4459,4586,9045,0,123
"00AXFY","Berrylands",9278,4603,4675,9170,108,111
"00AXFZ","Beverley",9488,4626,4862,9318,170,158
"00AXGA","Canbury",9604,4715,4889,9593,11,110
"00AXGB","Chessington North and Hook",8721,4270,4451,8721,0,62
"00AXGC","Chessington South",9488,4632,4856,9488,0,76
"00AXGD","Coombe Hill",10318,4913,5405,9323,995,236
"00AXGE","Coombe Vale",9271,4416,4855,9239,32,190
"00AXGF","Grove",7864,3871,3993,7827,37,75
"00AXGG","Norbiton",8844,4357,4487,8844,0,68
"00AXGH","Old Malden",9012,4482,4530,9010,0,145
"00AXGJ","St James",8571,4158,4413,8444,127,143
"00AXGK","St Mark's",9644,4925,4719,8257,1387,64
"00AXGL","Surbiton Hill",10191,4906,5285,9832,359,100
"00AXGM","Tolworth and Hook Rise",9531,4674,4857,9455,76,83
"00AXGN","Tudor",8403,3980,4423,8403,0,113
"00AYFZ","Bishop's",9194,4507,4687,8734,460,37
"00AYGA","Brixton Hill",12458,6197,6261,12257,201,55
"00AYGB","Clapham Common",12270,6229,6041,12142,128,159
"00AYGC","Clapham Town",13332,6679,6653,13032,300,132
"00AYGD","Coldharbour",14376,7123,7253,14340,36,75
"00AYGE","Ferndale",12898,6467,6431,12798,100,64
"00AYGF","Gipsy Hill",13601,6394,7207,13576,25,67
"00AYGG","Herne Hill",11805,5726,6079,11771,34,73
"00AYGH","Knight's Hill",13687,6508,7179,13373,314,85
"00AYGJ","Larkhall",13906,6834,7072,13639,267,82
"00AYGK","Oval",11983,6173,5810,11793,190,78
"00AYGL","Prince's",11636,5839,5797,11495,141,68
"00AYGM","St Leonard's",12215,6016,6199,11874,341,129
"00AYGN","Stockwell",13416,6749,6667,13403,13,115
"00AYGP","Streatham Hill",13359,6487,6872,13244,115,118
"00AYGQ","Streatham South",13449,6655,6794,13363,86,115
"00AYGR","Streatham Wells",12746,6355,6391,12645,101,56
"00AYGS","Thornton",12589,6074,6515,12576,13,71
"00AYGT","Thurlow Park",10958,5334,5624,10928,30,102
"00AYGU","Tulse Hill",13119,6415,6704,13086,33,58
"00AYGW","Vassall",13172,6391,6781,13029,143,89
"00AZGD","Bellingham",13642,6447,7195,13611,31,59
"00AZGE","Blackheath",13135,6389,6746,13049,86,115
"00AZGF","Brockley",13697,6655,7042,13091,606,100
"00AZGG","Catford South",14031,6836,7195,13926,105,106
"00AZGH","Crofton Park",13904,6711,7193,13836,68,71
"00AZGJ","Downham",14311,6783,7528,14298,13,49
"00AZGK","Evelyn",14512,7051,7461,14498,14,72
"00AZGL","Forest Hill",14039,6870,7169,13873,166,116
"00AZGM","Grove Park",14010,6656,7354,13945,65,101
"00AZGN","Ladywell",12430,6073,6357,12418,12,80
"00AZGP","Lee Green",12057,5825,6232,12049,8,88
"00AZGQ","Lewisham Central",13190,6457,6733,12882,308,68
"00AZGR","New Cross",15093,7404,7689,14773,320,78
"00AZGS","Perry Vale",14513,6964,7549,14438,75,90
"00AZGT","Rushey Green",13215,6386,6829,13004,211,49
"00AZGU","Sydenham",15353,7208,8145,15106,247,81
"00AZGW","Telegraph Hill",14426,6960,7466,14394,32,84
"00AZGX","Whitefoot",13364,6304,7060,13364,0,56
"00BAFX","Abbey",9526,4601,4925,9505,21,42
"00BAFY","Cannon Hill",9286,4625,4661,9274,12,85
"00BAFZ","Colliers Wood",9293,4547,4746,9228,65,55
"00BAGA","Cricket Green",10369,4928,5441,10269,100,63
"00BAGB","Dundonald",9018,4453,4565,9018,0,90
"00BAGC","Figge's Marsh",9896,4792,5104,9882,14,66
"00BAGD","Graveney",9384,4742,4642,9349,35,80
"00BAGE","Hillside",9074,4420,4654,8986,88,148
"00BAGF","Lavender Fields",9607,4728,4879,9607,0,43
"00BAGG","Longthornton",9629,4603,5026,9564,65,58
"00BAGH","Lower Morden",8561,4216,4345,8530,31,60
"00BAGJ","Merton Park",9144,4565,4579,9131,13,149
"00BAGK","Pollards Hill",9914,4788,5126,9903,11,79
"00BAGL","Ravensbury",9270,4449,4821,9202,68,50
"00BAGM","Raynes Park",9395,4416,4979,9239,156,143
"00BAGN","St Helier",9155,4382,4773,9131,24,37
"00BAGP","Trinity",8835,4315,4520,8697,138,68
"00BAGQ","Village",8914,4263,4651,8767,147,331
"00BAGR","West Barnes",9559,4719,4840,9553,6,121
"00BAGS","Wimbledon Park",10079,4962,5117,10025,54,159
"00BBGB","Beckton",13112,6344,6768,12755,357,64
"00BBGC","Boleyn",12289,5979,6310,12289,0,55
"00BBGD","Canning Town North",12061,5652,6409,11957,104,60
"00BBGE","Canning Town South",11278,5307,5971,11225,53,53
"00BBGF","Custom House",11875,5665,6210,11723,152,55
"00BBGG","East Ham Central",12162,6192,5970,12104,58,79
"00BBGH","East Ham North",11381,5833,5548,11325,56,76
"00BBGJ","East Ham South",12465,6029,6436,12394,71,50
"00BBGK","Forest Gate North",12634,6204,6430,12586,48,52
"00BBGL","Forest Gate South",13929,6862,7067,13594,335,74
"00BBGM","Green Street East",13212,6755,6457,13206,6,81
"00BBGN","Green Street West",12860,6554,6306,12815,45,92
"00BBGP","Little Ilford",13329,6529,6800,13223,106,88
"00BBGQ","Manor Park",12103,5969,6134,11989,114,77
"00BBGR","Plaistow North",13236,6520,6716,13228,8,72
"00BBGS","Plaistow South",11832,5761,6071,11740,92,58
"00BBGT","Royal Docks",6186,3081,3105,6173,13,42
"00BBGU","Stratford and New Town",12378,5972,6406,12355,23,60
"00BBGW","Wall End",12932,6552,6380,12932,0,85
"00BBGX","West Ham",12637,6112,6525,12583,54,63
"00BCFY","Aldborough",11611,5597,6014,11479,132,112
"00BCFZ","Barkingside",11303,5466,5837,11296,7,161
"00BCGA","Bridge",11211,5388,5823,11211,0,76
"00BCGB","Chadwell",11030,5293,5737,10872,158,56
"00BCGC","Church End",9997,4869,5128,9366,631,115
"00BCGD","Clayhall",11855,5851,6004,11855,0,197
"00BCGE","Clementswood",11286,5585,5701,11265,21,104
"00BCGF","Cranbrook",11858,5810,6048,11691,167,147
"00BCGG","Fairlop",10420,5050,5370,10412,8,72
"00BCGH","Fullwell",11269,5329,5940,11234,35,86
"00BCGJ","Goodmayes",10994,5444,5550,10959,35,95
"00BCGK","Hainault",11367,5387,5980,11335,32,40
"00BCGL","Loxford",13585,6523,7062,13395,190,91
"00BCGM","Mayfield",11226,5541,5685,11161,65,135
"00BCGN","Monkhams",9866,4657,5209,9714,152,200
"00BCGP","Newbury",13074,6504,6570,13058,16,153
"00BCGQ","Roding",10770,5236,5534,10749,21,87
"00BCGR","Seven Kings",11910,5835,6075,11646,264,124
"00BCGS","Snaresbrook",10854,5030,5824,10646,208,130
"00BCGT","Valentines",11643,5821,5822,11453,190,108
"00BCGU","Wanstead",11506,5633,5873,11374,132,154
"00BDFW","Barnes",9823,4712,5111,9732,91,266
"00BDFX","East Sheen",9744,4647,5097,9583,161,283
"00BDFY","Fulwell and Hampton Hill",9448,4578,4870,9395,53,142
"00BDFZ","Ham, Petersham and Richmond Riverside",9678,4809,4869,9238,440,107
"00BDGA","Hampton",9429,4532,4897,9368,61,142
"00BDGB","Hampton North",9077,4374,4703,9030,47,129
"00BDGC","Hampton Wick",9081,4437,4644,8940,141,160
"00BDGD","Heathfield",9541,4599,4942,9515,26,99
"00BDGE","Kew",9445,4537,4908,9353,92,191
"00BDGF","Mortlake and Barnes Common",9925,4806,5119,9869,56,124
"00BDGG","North Richmond",9767,4672,5095,9763,4,164
"00BDGH","St Margarets and North Twickenham",9946,4828,5118,9667,279,154
"00BDGJ","South Richmond",10278,4941,5337,9980,298,229
"00BDGK","South Twickenham",9027,4301,4726,8527,500,147
"00BDGL","Teddington",9615,4587,5028,9567,48,164
"00BDGM","Twickenham Riverside",9590,4674,4916,9377,213,137
"00BDGN","West Twickenham",9772,4808,4964,9740,32,80
"00BDGP","Whitton",9149,4496,4653,8998,151,114
"00BEGC","Brunswick Park",11136,5355,5781,10973,163,65
"00BEGD","Camberwell Green",12798,6274,6524,12555,243,75
"00BEGE","Cathedrals",13115,6439,6676,11017,2098,60
"00BEGF","Chaucer",13058,6628,6430,11811,1247,69
"00BEGG","College",10294,4967,5327,10221,73,152
"00BEGH","East Dulwich",10840,5170,5670,10762,78,56
"00BEGJ","East Walworth",12000,5933,6067,11975,25,68
"00BEGK","Faraday",12697,6035,6662,12678,19,59
"00BEGL","Grange",11985,6011,5974,11595,390,37
"00BEGM","Livesey",12070,5859,6211,12058,12,63
"00BEGN","Newington",12870,6238,6632,12810,60,63
"00BEGP","Nunhead",10271,4959,5312,10236,35,56
"00BEGQ","Peckham",11381,5404,5977,11381,0,73
"00BEGR","Peckham Rye",11248,5333,5915,11194,54,55
"00BEGS","Riverside",10979,5621,5358,10726,253,38
"00BEGT","Rotherhithe",11395,5670,5725,11379,16,38
"00BEGU","South Bermondsey",11631,5683,5948,11599,32,35
"00BEGW","South Camberwell",11295,5373,5922,10871,424,84
"00BEGX","Surrey Docks",11346,6057,5289,11321,25,35
"00BEGY","The Lane",11973,5756,6217,11890,83,70
"00BEGZ","Village",10484,5052,5432,10460,24,214
"00BFGC","Beddington North",9941,4937,5004,9936,5,94
"00BFGD","Beddington South",10423,5000,5423,10365,58,145
"00BFGE","Belmont",9790,4753,5037,9592,198,165
"00BFGF","Carshalton Central",9833,4734,5099,9709,124,118
"00BFGG","Carshalton South and Clockhouse",9747,4758,4989,9542,205,170
"00BFGH","Cheam",9695,4588,5107,9488,207,206
"00BFGJ","Nonsuch",10160,4987,5173,10135,25,118
"00BFGK","St Helier",10798,5205,5593,10702,96,39
"00BFGL","Stonecot",10327,5121,5206,10327,0,80
"00BFGM","Sutton Central",10016,4896,5120,9960,56,55
"00BFGN","Sutton North",9675,4648,5027,9576,99,82
"00BFGP","Sutton South",8827,4184,4643,8535,292,86
"00BFGQ","Sutton West",9980,4821,5159,9851,129,104
"00BFGR","The Wrythe",10384,5047,5337,10361,23,56
"00BFGS","Wallington North",9974,4834,5140,9921,53,85
"00BFGT","Wallington South",9602,4473,5129,9459,143,133
"00BFGU","Wandle Valley",10722,5128,5594,10722,0,41
"00BFGW","Worcester Park",9874,4764,5110,9823,51,86
"00BGFW","Bethnal Green North",11765,5713,6052,11445,320,43
"00BGFX","Bethnal Green South",13675,6935,6740,13615,60,57
"00BGFY","Blackwall and Cubitt Town",11939,6190,5749,11939,0,36
"00BGFZ","Bow East",8797,4248,4549,8765,32,18
"00BGGA","Bow West",10421,5029,5392,10419,0,38
"00BGGB","Bromley-by-Bow",11581,5644,5937,11497,84,52
"00BGGC","East India and Lansbury",11496,5605,5891,11318,178,47
"00BGGD","Limehouse",12484,6223,6261,12333,151,45
"00BGGE","Mile End and Globe Town",11801,5557,6244,11329,472,35
"00BGGF","Mile End East",11139,5448,5691,11063,76,38
"00BGGG","Millwall",12892,6769,6123,12848,44,60
"00BGGH","St Dunstan's and Stepney Green",12679,6180,6499,12520,159,58
"00BGGJ","St Katherine's and Wapping",11245,5977,5268,11141,104,56
"00BGGK","Shadwell",12078,6188,5890,12028,50,69
"00BGGL","Spitalfields and Banglatown",8383,4436,3947,8289,94,30
"00BGGM","Weavers",11685,5880,5805,11563,122,31
"00BGGN","Whitechapel",12046,6156,5890,11875,171,42
"00BHFX","Cann Hall",11388,5566,5822,11310,78,50
"00BHFY","Cathall",10608,5235,5373,10563,45,56
"00BHFZ","Chapel End",11098,5412,5686,11092,6,49
"00BHGA","Chingford Green",9497,4530,4967,9363,134,59
"00BHGB","Endlebury",10146,4946,5200,10117,29,68
"00BHGC","Forest",10427,5222,5205,10305,122,99
"00BHGD","Grove Green",11400,5617,5783,11379,21,48
"00BHGE","Hale End and Highams Park",10075,4912,5163,10041,34,83
"00BHGF","Hatch Lane",9879,4693,5186,9811,68,66
"00BHGG","High Street",11152,5430,5722,11119,33,48
"00BHGH","Higham Hill",11161,5353,5808,11159,0,47
"00BHGJ","Hoe Street",11579,5550,6029,11268,311,48
"00BHGK","Larkswood",10582,5057,5525,10445,137,64
"00BHGL","Lea Bridge",12340,6011,6329,12207,133,52
"00BHGM","Leyton",12522,6079,6443,12448,74,60
"00BHGN","Leytonstone",10635,5272,5363,10352,283,75
"00BHGP","Markhouse",10866,5267,5599,10844,22,56
"00BHGQ","Valley",10680,5168,5512,10625,55,60
"00BHGR","William Morris",10975,5380,5595,10919,56,48
"00BHGS","Wood Street",11331,5545,5786,11222,109,81
"00BJFZ","Balham",12840,6198,6642,12760,80,181
"00BJGA","Bedford",13017,6455,6562,12935,82,145
"00BJGB","Earlsfield",12903,5950,6953,12804,99,54
"00BJGC","East Putney",13196,6231,6965,13076,120,196
"00BJGD","Fairfield",12034,5825,6209,12013,21,93
"00BJGE","Furzedown",13539,6415,7124,13133,406,123
"00BJGF","Graveney",13213,6353,6860,13062,151,82
"00BJGG","Latchmere",12596,5950,6646,12556,40,78
"00BJGH","Nightingale",13549,6406,7143,13116,433,180
"00BJGJ","Northcote",12851,6191,6660,12805,46,132
"00BJGK","Queenstown",12505,5858,6647,12463,42,108
"00BJGL","Roehampton",13011,5624,7387,12116,895,104
"00BJGM","St Mary's Park",12395,5916,6479,12064,331,130
"00BJGN","Shaftesbury",12464,6047,6417,12461,3,74
"00BJGP","Southfields",14063,6664,7399,14063,0,94
"00BJGQ","Thamesfield",12344,5973,6371,12336,8,202
"00BJGR","Tooting",13261,6352,6909,13247,14,79
"00BJGS","Wandsworth Common",13555,6816,6739,12684,871,292
"00BJGT","West Hill",14356,6696,7660,13649,707,135
"00BJGU","West Putney",12688,5822,6866,12630,58,225
"00BKGA","Abbey Road",9554,4464,5090,9451,103,154
"00BKGB","Bayswater",8145,3972,4173,8120,25,116
"00BKGC","Bryanston and Dorset Square",10669,5468,5201,10201,468,124
"00BKGD","Churchill",8391,4016,4375,8253,138,75
"00BKGE","Church Street",6490,3014,3476,6398,92,27
"00BKGF","Harrow Road",8621,4073,4548,8579,42,34
"00BKGG","Hyde Park",10330,5327,5003,9564,766,113
"00BKGH","Knightsbridge and Belgravia",8949,4464,4485,8014,935,200
"00BKGJ","Lancaster Gate",12003,6053,5950,11461,542,108
"00BKGK","Little Venice",8100,3962,4138,8028,72,97
"00BKGL","Maida Vale",9647,4579,5068,9597,50,71
"00BKGM","Marylebone High Street",8860,4401,4459,8474,386,115
"00BKGN","Queen's Park",9179,4264,4915,9169,10,63
"00BKGP","Regent's Park",11049,5171,5878,11031,18,130
"00BKGQ","St James's",8658,4726,3932,7627,1031,85
"00BKGR","Tachbrook",8342,4060,4282,8249,93,57
"00BKGS","Vincent Square",8630,4169,4461,8087,543,113
"00BKGT","Warwick",8131,4067,4064,7940,191,98
"00BKGU","Westbourne",10075,4733,5342,9901,174,48
"00BKGW","West End",7463,3824,3639,6869,594,65
"00BLFA","Astley Bridge",13979,6751,7228,13834,145,127
"00BLFB","Blackrod",13098,6476,6622,12935,163,126
"00BLFC","Bradshaw",13177,6355,6822,13133,44,164
"00BLFD","Breightmet",13595,6607,6988,13402,193,95
"00BLFE","Bromley Cross",13837,6710,7127,13823,14,185
"00BLFF","Burnden",12969,6460,6509,12548,421,87
"00BLFG","Central",10713,5262,5451,10619,94,45
"00BLFH","Daubhill",11813,5790,6023,11775,38,77
"00BLFJ","Deane-Cum-Heaton",16987,8147,8840,16765,222,304
"00BLFK","Derby",13152,6482,6670,12737,415,102
"00BLFL","Farnworth",12993,6209,6784,12947,46,42
"00BLFM","Halliwell",12026,5860,6166,11920,106,61
"00BLFN","Harper Green",13768,6720,7048,13624,144,60
"00BLFP","Horwich",14343,6917,7426,14244,99,158
"00BLFQ","Hulton Park",16370,8059,8311,16319,51,169
"00BLFR","Kearsley",13248,6423,6825,13202,46,49
"00BLFS","Little Lever",11505,5712,5793,11479,26,70
"00BLFT","Smithills",10881,5265,5616,10823,58,106
"00BLFU","Tonge",10153,4788,5365,10090,63,30
"00BLFW","Westhoughton",12430,6108,6322,12422,8,81
"00BMFA","Besses",9272,4386,4886,9225,47,58
"00BMFB","Church",11029,5410,5619,10900,129,164
"00BMFC","East",10259,5024,5235,10112,147,39
"00BMFD","Elton",11855,5771,6084,11739,116,141
"00BMFE","Holyrood",10721,5171,5550,10622,99,72
"00BMFF","Moorside",10337,5099,5238,10100,237,85
"00BMFG","Pilkington Park",10004,4767,5237,9915,89,149
"00BMFH","Radcliffe Central",11625,5695,5930,11563,62,40
"00BMFJ","Radcliffe North",13824,6723,7101,13731,93,102
"00BMFK","Radcliffe South",10757,5153,5604,10598,159,75
"00BMFL","Ramsbottom",14635,7372,7263,14248,387,200
"00BMFM","Redvales",10996,5344,5652,10840,156,66
"00BMFN","St. Mary's",11610,5639,5971,11135,475,117
"00BMFP","Sedgley",11115,5380,5735,10990,125,157
"00BMFQ","Tottington",12511,6085,6426,12336,175,209
"00BMFR","Unsworth",10058,4923,5135,10042,16,118
"00BNFA","Ardwick",9809,5059,4750,8675,1134,39
"00BNFB","Baguley",11402,5382,6020,11180,222,32
"00BNFC","Barlow Moor",12895,6296,6599,12289,606,63
"00BNFD","Benchill",10439,4810,5629,10428,11,17
"00BNFE","Beswick and Clayton",9371,4477,4894,9186,185,18
"00BNFF","Blackley",10196,4720,5476,10120,76,38
"00BNFG","Bradford",8467,4169,4298,8379,88,18
"00BNFH","Brooklands",10779,5147,5632,10757,22,59
"00BNFJ","Burnage",13706,6389,7317,13706,0,66
"00BNFK","Central",11689,6203,5486,10175,1514,42
"00BNFL","Charlestown",10779,5253,5526,10676,103,38
"00BNFM","Cheetham",12846,6515,6331,12359,487,60
"00BNFN","Chorlton",14356,7002,7354,14198,158,90
"00BNFP","Crumpsall",11363,5692,5671,11117,246,65
"00BNFQ","Didsbury",14292,6973,7319,13956,336,192
"00BNFR","Fallowfield",14132,6827,7305,11749,2383,70
"00BNFS","Gorton North",12670,6073,6597,12466,204,26
"00BNFT","Gorton South",11503,5508,5995,11491,12,34
"00BNFU","Harpurhey",8834,4248,4586,8698,136,14
"00BNFW","Hulme",10449,5477,4972,7531,2918,28
"00BNFX","Levenshulme",12691,6352,6339,12563,128,72
"00BNFY","Lightbowne",10467,5083,5384,10445,22,34
"00BNFZ","Longsight",16007,7938,8069,15488,519,104
"00BNGA","Moss Side",10977,5314,5663,10957,20,55
"00BNGB","Moston",12390,5854,6536,12270,120,73
"00BNGC","Newton Heath",10714,5058,5656,10617,97,18
"00BNGD","Northenden",12662,5990,6672,12530,132,66
"00BNGE","Old Moat",15277,7493,7784,15041,236,95
"00BNGF","Rusholme",14422,7358,7064,11669,2753,82
"00BNGG","Sharston",10058,4714,5344,9863,195,25
"00BNGH","Whalley Range",12109,6020,6089,11928,181,119
"00BNGJ","Withington",14141,7013,7128,14046,95,125
"00BNGK","Woodhouse Park",10927,5163,5764,10830,97,23
"00BPFA","Alexandra",11159,5326,5833,10889,270,52
"00BPFB","Chadderton Central",10784,5330,5454,10622,162,95
"00BPFC","Chadderton North",10269,4969,5300,10265,4,79
"00BPFD","Chadderton South",10061,4863,5198,10020,41,44
"00BPFE","Coldhurst",11935,5889,6046,11828,107,59
"00BPFF","Crompton",11066,5360,5706,11060,6,90
"00BPFG","Failsworth East",10728,5230,5498,10691,37,39
"00BPFH","Failsworth West",9827,4675,5152,9721,106,26
"00BPFJ","Hollinwood",9910,4671,5239,9909,3,29
"00BPFK","Lees",10132,4794,5338,10034,98,42
"00BPFL","Royton North",10588,5041,5547,10535,53,113
"00BPFM","Royton South",10373,4978,5395,10268,105,73
"00BPFN","Saddleworth East",13042,6353,6689,13021,21,205
"00BPFP","Saddleworth West",11309,5491,5818,11212,97,130
"00BPFQ","St. James",9684,4628,5056,9610,74,24
"00BPFR","St. Marys",10785,5226,5559,10734,51,45
"00BPFS","St. Pauls",10496,5150,5346,10433,63,59
"00BPFT","Shaw",10655,5034,5621,10484,171,85
"00BPFU","Waterhead",12876,6240,6636,12780,96,66
"00BPFW","Werneth",11594,5788,5806,11370,224,77
"00BQFA","Balderstone",9699,4616,5083,9670,29,50
"00BQFB","Brimrod and Deeplish",8556,4197,4359,8401,155,55
"00BQFC","Castleton",9715,4638,5077,9531,184,69
"00BQFD","Central and Falinge",9469,4772,4697,9229,240,48
"00BQFE","Healey",13458,6718,6740,13077,381,134
"00BQFF","Heywood North",9512,4623,4889,9470,42,50
"00BQFG","Heywood South",11128,5414,5714,11003,125,79
"00BQFH","Heywood West",8600,4143,4457,8490,110,45
"00BQFJ","Littleborough",12275,6016,6259,12077,198,119
"00BQFK","Middleton Central",9080,4329,4751,8996,84,32
"00BQFL","Middleton East",8661,4162,4499,8643,18,51
"00BQFM","Middleton North",11510,5609,5901,11387,123,56
"00BQFN","Middleton South",9950,4808,5142,9883,67,111
"00BQFP","Middleton West",6487,3052,3435,6483,4,14
"00BQFQ","Milnrow",11561,5634,5927,11511,50,95
"00BQFR","Newbold",11166,5437,5729,11135,31,51
"00BQFS","Norden and Bamford",12413,6091,6322,12355,58,280
"00BQFT","Smallbridge and Wardleworth",13983,6858,7125,13908,75,63
"00BQFU","Spotland",8974,4193,4781,8835,139,70
"00BQFW","Wardle",9160,4395,4765,9002,158,105
"00BRFA","Barton",10434,5181,5253,10305,129,24
"00BRFB","Blackfriars",8078,4166,3912,7009,1069,20
"00BRFC","Broughton",7784,3819,3965,7596,188,39
"00BRFD","Cadishead",8916,4364,4552,8916,0,28
"00BRFE","Claremont",12763,6193,6570,12584,179,55
"00BRFF","Eccles",11413,5546,5867,11118,295,85
"00BRFG","Irlam",10209,4985,5224,10158,51,24
"00BRFH","Kersal",11940,5870,6070,11672,268,295
"00BRFJ","Langworthy",7104,3578,3526,7104,0,9
"00BRFK","Little Hulton",10216,4868,5348,10115,101,25
"00BRFL","Ordsall",5935,3040,2895,5930,5,9
"00BRFM","Pendlebury",14298,7116,7182,13785,513,27
"00BRFN","Pendleton",9750,4816,4934,7663,2087,13
"00BRFP","Swinton North",11691,5701,5990,11611,80,29
"00BRFQ","Swinton South",12592,6170,6422,12443,149,70
"00BRFR","Walkden North",11219,5377,5842,11150,69,36
"00BRFS","Walkden South",15701,7722,7979,15652,49,107
"00BRFT","Weaste and Seedley",9367,4600,4767,9097,270,34
"00BRFU","Winton",12752,6215,6537,12668,84,35
"00BRFW","Worsley and Boothstown",13941,6864,7077,13839,102,158
"00BSFA","Bredbury",15126,7413,7713,15009,117,83
"00BSFB","Brinnington",9749,4750,4999,9694,55,11
"00BSFC","Cale Green",12178,5922,6256,12139,39,46
"00BSFD","Cheadle",14261,6649,7612,14166,95,209
"00BSFE","Cheadle Hulme North",14690,6960,7730,14630,60,153
"00BSFF","Cheadle Hulme South",14262,6958,7304,14214,48,211
"00BSFG","Davenport",11764,5610,6154,11480,284,83
"00BSFH","East Bramhall",15926,7740,8186,15858,68,292
"00BSFJ","Edgeley",11995,5854,6141,11958,37,41
"00BSFK","Great Moor",14303,6848,7455,14117,186,71
"00BSFL","Hazel Grove",15265,7431,7834,15215,50,168
"00BSFM","Heald Green",12640,6120,6520,12504,136,127
"00BSFN","Heaton Mersey",15635,7584,8051,15557,78,204
"00BSFP","Heaton Moor",12695,6243,6452,12422,273,172
"00BSFQ","Manor",12341,6021,6320,12274,67,44
"00BSFR","North Marple",11631,5588,6043,11428,203,217
"00BSFS","North Reddish",16120,7750,8370,16102,18,46
"00BSFT","Romiley",13703,6526,7177,13655,48,123
"00BSFU","South Marple",11849,5680,6169,11719,130,186
"00BSFW","South Reddish",13935,6681,7254,13769,166,45
"00BSFX","West Bramhall",14460,6940,7520,14345,115,336
"00BTFA","Ashton Hurst",11994,5855,6139,11920,74,123
"00BTFB","Ashton St. Michael's",11050,5405,5645,10810,240,58
"00BTFC","Ashton St. Peters'",9657,4896,4761,9568,89,58
"00BTFD","Ashton Waterloo",10825,5181,5644,10718,107,69
"00BTFE","Audenshaw",12790,6170,6620,12651,139,56
"00BTFF","Denton North East",12295,5917,6378,12273,22,47
"00BTFG","Denton South",10601,5075,5526,10544,57,44
"00BTFH","Denton West",11384,5509,5875,11321,63,49
"00BTFJ","Droylsden East",12350,5962,6388,12315,35,44
"00BTFK","Droylsden West",10822,5204,5618,10786,36,31
"00BTFL","Dukinfield",12976,6344,6632,12933,43,69
"00BTFM","Dukinfield Stalybridge",10375,5017,5358,10255,120,71
"00BTFN","Hyde Godley",11091,5290,5801,10951,140,40
"00BTFP","Hyde Newton",11951,5816,6135,11863,88,48
"00BTFQ","Hyde Werneth",11560,5566,5994,11336,224,78
"00BTFR","Longdendale",9733,4705,5028,9674,59,72
"00BTFS","Mossley",9856,4871,4985,9759,97,58
"00BTFT","Stalybridge North",10686,5198,5488,10625,61,76
"00BTFU","Stalybridge South",11047,5366,5681,10876,171,131
"00BUFA","Altrincham",10778,5211,5567,10522,256,147
"00BUFB","Bowdon",11856,5858,5998,11718,138,336
"00BUFC","Broadheath",11267,5496,5771,11215,52,117
"00BUFD","Brooklands",9773,4782,4991,9696,77,147
"00BUFE","Bucklow",7723,3724,3999,7699,24,22
"00BUFF","Clifford",10095,4964,5131,10043,52,62
"00BUFG","Davyhulme East",9139,4436,4703,9061,78,83
"00BUFH","Davyhulme West",9593,4582,5011,9520,73,92
"00BUFJ","Flixton",9473,4568,4905,9338,135,92
"00BUFK","Hale",10300,4987,5313,10260,40,282
"00BUFL","Longford",9499,4684,4815,9465,34,66
"00BUFM","Mersey St. Mary's",12254,5940,6314,12057,197,186
"00BUFN","Park",7605,3647,3958,7602,3,37
"00BUFP","Priory",9667,4713,4954,9558,109,108
"00BUFQ","St. Martin's",10929,5234,5695,10880,49,92
"00BUFR","Sale Moor",9671,4698,4973,9626,45,82
"00BUFS","Stretford",9685,4720,4965,9657,28,75
"00BUFT","Talbot",8176,4041,4135,8128,48,24
"00BUFU","Timperley",11049,5491,5558,10980,69,149
"00BUFW","Urmston",9802,4726,5076,9650,152,69
"00BUFX","Village",11811,5659,6152,11781,30,143
"00BWFA","Abram",11759,5843,5916,11705,54,40
"00BWFB","Ashton-Golborne",13961,6899,7062,13869,92,90
"00BWFC","Aspull-Standish",14716,7192,7524,14561,155,185
"00BWFD","Atherton",10998,5331,5667,10914,84,34
"00BWFE","Bedford-Astley",10518,5172,5346,10508,10,67
"00BWFF","Beech Hill",11485,5572,5913,11421,64,52
"00BWFG","Bryn",12433,6119,6314,12393,40,96
"00BWFH","Hindley",13699,6653,7046,13560,139,60
"00BWFJ","Hindley Green",13854,6893,6961,13751,103,66
"00BWFK","Hindsford",13821,6781,7040,13722,99,62
"00BWFL","Hope Carr",13022,6340,6682,12995,27,99
"00BWFM","Ince",10184,4982,5202,10150,34,19
"00BWFN","Langtree",14630,7254,7376,14617,13,188
"00BWFP","Leigh Central",11518,5822,5696,11082,436,26
"00BWFQ","Leigh East",13975,6802,7173,13674,301,71
"00BWFR","Lightshaw",15526,7532,7994,15428,98,119
"00BWFS","Newtown",10120,4900,5220,10120,0,23
"00BWFT","Norley",9509,4628,4881,9469,40,29
"00BWFU","Orrell",11203,5447,5756,11149,54,108
"00BWFW","Swinley",10556,5165,5391,10444,112,92
"00BWFX","Tyldesley East",15415,7604,7811,15410,5,139
"00BWFY","Whelley",10207,5023,5184,10098,109,33
"00BWFZ","Winstanley",15851,7805,8046,15781,70,124
"00BWGA","Worsley Mesnes",12455,6097,6358,12348,107,43
"00BXFA","Cantril Farm",4634,2174,2460,4634,0,7
"00BXFB","Cherryfield",5823,2686,3137,5823,0,13
"00BXFC","Halewood East",10934,5332,5602,10924,10,57
"00BXFD","Halewood South",5846,2751,3095,5837,9,17
"00BXFE","Halewood West",5911,2734,3177,5761,150,26
"00BXFF","Kirkby Central",6258,2858,3400,6225,33,14
"00BXFG","Knowsley Park",6709,3214,3495,6671,38,26
"00BXFH","Longview",5899,2747,3152,5789,110,6
"00BXFJ","Northwood",4777,2212,2565,4711,66,9
"00BXFK","Page Moss",7401,3463,3938,7331,70,11
"00BXFL","Park",7126,3424,3702,7104,22,18
"00BXFM","Prescot East",6400,3041,3359,6379,21,20
"00BXFN","Prescot West",6288,2965,3323,6228,60,27
"00BXFP","Princess",5895,2661,3234,5895,0,16
"00BXFQ","Roby",9353,4511,4842,9103,250,46
"00BXFR","St. Gabriels",5902,2735,3167,5857,45,12
"00BXFS","St. Michaels",5998,2808,3190,5932,66,21
"00BXFT","Swanside",7907,3812,4095,7844,63,40
"00BXFU","Tower Hill",8929,4164,4765,8920,9,23
"00BXFW","Whiston North",6912,3287,3625,6806,106,22
"00BXFX","Whiston South",8096,3947,4149,8093,3,36
"00BXFY","Whitefield",7461,3538,3923,7449,12,8
"00BYFA","Abercromby",11473,5647,5826,9088,2385,37
"00BYFB","Aigburth",16269,7871,8398,14229,2040,126
"00BYFC","Allerton",15624,7526,8098,15407,217,137
"00BYFD","Anfield",14002,6568,7434,13663,339,25
"00BYFE","Arundel",13543,6474,7069,12437,1106,65
"00BYFF","Breckfield",10814,5036,5778,10791,23,19
"00BYFG","Broadgreen",14889,6919,7970,14366,523,34
"00BYFH","Childwall",16461,7901,8560,16032,429,155
"00BYFJ","Church",18314,8633,9681,18164,150,183
"00BYFK","Clubmoor",13387,6132,7255,13331,56,35
"00BYFL","County",14275,6573,7702,14267,8,23
"00BYFM","Croxteth",16543,7976,8567,16426,117,123
"00BYFN","Dingle",13246,6338,6908,12868,378,50
"00BYFP","Dovecot",13794,6502,7292,13723,71,15
"00BYFQ","Everton",7398,3717,3681,6173,1225,13
"00BYFR","Fazakerley",15062,7429,7633,14436,626,42
"00BYFS","Gillmoss",18665,8948,9717,18467,198,62
"00BYFT","Granby",10978,5390,5588,10616,362,44
"00BYFU","Grassendale",15216,7336,7880,15021,195,185
"00BYFW","Kensington",12740,6209,6531,12659,81,32
"00BYFX","Melrose",12500,6086,6414,12428,72,20
"00BYFY","Netherley",8068,3703,4365,7998,70,9
"00BYFZ","Old Swan",12938,5999,6939,12732,206,32
"00BYGA","Picton",14062,6505,7557,14062,0,47
"00BYGB","Pirrie",13077,6054,7023,13047,30,26
"00BYGC","St. Mary's",12484,5927,6557,12448,36,25
"00BYGD","Smithdown",10757,5004,5753,9731,1026,30
"00BYGE","Speke",9098,4163,4935,9051,47,13
"00BYGF","Tuebrook",14490,7129,7361,14359,131,43
"00BYGG","Valley",9751,4630,5121,9686,65,34
"00BYGH","Vauxhall",6699,3131,3568,6634,65,15
"00BYGJ","Warbreck",18020,9185,8835,17238,782,47
"00BYGK","Woolton",14836,7164,7672,14729,107,203
"00BZFA","Billinge and Seneley Green",12717,6339,6378,12641,76,177
"00BZFB","Blackbrook",9128,4414,4714,9115,13,50
"00BZFC","Broad Oak",9169,4447,4722,9130,39,25
"00BZFD","Eccleston",10528,5130,5398,10470,58,154
"00BZFE","Grange Park",9940,4782,5158,9807,133,66
"00BZFF","Haydock",11962,5866,6096,11880,82,59
"00BZFG","Marshalls Cross",8099,3898,4201,8027,72,33
"00BZFH","Moss Bank",10276,4922,5354,10252,24,62
"00BZFJ","Newton East",10176,4979,5197,10069,107,47
"00BZFK","Newton West",11242,5417,5825,11184,58,49
"00BZFL","Parr and Hardshaw",8277,3887,4390,8060,217,37
"00BZFM","Queen's Park",8987,4304,4683,8914,73,41
"00BZFN","Rainford",8344,4041,4303,8288,56,165
"00BZFP","Rainhill",11913,5760,6153,11688,225,130
"00BZFQ","Sutton and Bold",9394,4646,4748,9341,53,41
"00BZFR","Thatto Heath",9393,4635,4758,9293,100,51
"00BZFS","West Sutton",8677,4176,4501,8677,0,48
"00BZFT","Windle",8621,4071,4550,8553,68,116
"00CAGA","Ainsdale",12723,5987,6736,12618,105,223
"00CAGB","Birkdale",12265,5793,6472,12222,43,214
"00CAGC","Blundellsands",11514,5305,6209,11169,345,191
"00CAGD","Cambridge",12304,5436,6868,11279,1025,118
"00CAGE","Church",12485,5996,6489,12146,339,76
"00CAGF","Derby",12256,5708,6548,12179,77,40
"00CAGG","Dukes",12063,5516,6547,11215,848,144
"00CAGH","Ford",12853,5983,6870,12841,12,48
"00CAGJ","Harington",13019,6272,6747,12782,237,275
"00CAGK","Kew",13191,6256,6935,13002,189,100
"00CAGL","Linacre",13200,6363,6837,13012,188,14
"00CAGM","Litherland",12074,5650,6424,12050,24,30
"00CAGN","Manor",11866,5604,6262,11828,38,152
"00CAGP","Meols",12853,6040,6813,12750,103,119
"00CAGQ","Molyneux",12970,6194,6776,12911,59,96
"00CAGR","Netherton and Orrell",12981,6138,6843,12942,39,46
"00CAGS","Norwood",14937,7095,7842,14752,185,105
"00CAGT","Park",14856,7206,7650,14696,160,131
"00CAGU","Ravenmeols",11977,5669,6308,11870,107,178
"00CAGW","St Oswald",14276,6600,7676,14093,183,27
"00CAGX","Sudell",14041,6875,7166,13563,478,113
"00CAGY","Victoria",12254,5803,6451,12139,115,107
"00CBFA","Bebington",13720,6509,7211,13690,30,163
"00CBFB","Bidston",10446,4725,5721,10409,37,26
"00CBFC","Birkenhead",12876,6154,6722,12794,82,30
"00CBFD","Bromborough",13963,6577,7386,13807,156,87
"00CBFE","Clatterbridge",16906,8035,8871,16487,419,308
"00CBFF","Claughton",13723,6498,7225,13395,328,168
"00CBFG","Eastham",13637,6562,7075,13598,39,130
"00CBFH","Egerton",13392,6349,7043,13101,291,60
"00CBFJ","Heswall",16012,7474,8538,15866,146,391
"00CBFK","Hoylake",15662,7220,8442,15137,525,332
"00CBFL","Leasowe",12591,5895,6696,12591,0,57
"00CBFM","Liscard",14301,6750,7551,14121,180,74
"00CBFN","Moreton",12532,5980,6552,12478,54,87
"00CBFP","New Brighton",14450,6869,7581,13942,508,106
"00CBFQ","Oxton",14066,6680,7386,13688,378,156
"00CBFR","Prenton",14429,6787,7642,14167,262,137
"00CBFS","Royden",16166,7758,8408,16163,3,280
"00CBFT","Seacombe",15158,7081,8077,15129,29,50
"00CBFU","Thurstaston",15548,7350,8198,15528,20,300
"00CBFW","Tranmere",11668,5399,6269,11557,111,25
"00CBFX","Upton",15731,7268,8463,15540,191,104
"00CBFY","Wallasey",15316,7262,8054,15264,52,192
"00CCFA","Ardsley",8705,4203,4502,8599,106,53
"00CCFB","Athersley",8238,3926,4312,8209,29,13
"00CCFC","Brierley",8813,4247,4566,8679,134,34
"00CCFD","Central",10439,5157,5282,10362,77,38
"00CCFE","Cudworth",10021,4954,5067,9891,130,48
"00CCFF","Darfield",10234,4971,5263,10134,100,56
"00CCFG","Darton",13819,6720,7099,13613,206,97
"00CCFH","Dearne South",11532,5655,5877,11456,76,39
"00CCFJ","Dearne Thurnscoe",10538,5091,5447,10460,78,22
"00CCFK","Dodworth",13519,6666,6853,13444,75,80
"00CCFL","Hoyland East",10141,4913,5228,10023,118,38
"00CCFM","Hoyland West",8046,3880,4166,8003,43,37
"00CCFN","Monk Bretton",10605,5084,5521,10504,101,41
"00CCFP","North West",8904,4329,4575,8734,170,56
"00CCFQ","Park",7136,3418,3718,7029,107,24
"00CCFR","Penistone East",9769,4818,4951,9726,43,124
"00CCFS","Penistone West",11289,5542,5747,11243,46,151
"00CCFT","Royston",11488,5609,5879,11445,43,45
"00CCFU","South West",8789,4283,4506,8618,171,56
"00CCFW","Wombwell North",6164,3013,3151,6136,28,16
"00CCFX","Wombwell South",10358,5003,5355,10216,142,43
"00CCFY","Worsbrough",9516,4614,4902,9393,123,54
"00CEFA","Adwick",16040,7735,8305,15866,174,60
"00CEFB","Armthorpe",17382,8415,8967,17200,182,119
"00CEFC","Askern",11042,5400,5642,10899,143,74
"00CEFD","Balby",14280,6838,7442,14035,245,77
"00CEFE","Bentley Central",11591,5583,6008,11511,80,41
"00CEFF","Bentley North Road",11570,5632,5938,11561,9,43
"00CEFG","Bessacarr",13343,6353,6990,13267,76,233
"00CEFH","Central",10185,5052,5133,9894,291,34
"00CEFJ","Conisbrough",14172,6794,7378,14051,121,41
"00CEFK","Edlington and Warmsworth",12028,5894,6134,11952,76,48
"00CEFL","Hatfield",16184,8549,7635,14744,1440,109
"00CEFM","Intake",10456,4937,5519,10367,89,77
"00CEFN","Mexborough",14620,7146,7474,14456,164,49
"00CEFP","Richmond",14191,6931,7260,14028,163,135
"00CEFQ","Rossington",13255,6512,6743,13164,91,76
"00CEFR","South East",18473,9001,9472,18376,97,241
"00CEFS","Southern Parks",14502,7086,7416,14384,118,227
"00CEFT","Stainforth",15932,7726,8206,15851,81,124
"00CEFU","Thorne",16592,8121,8471,16419,173,74
"00CEFW","Town Field",10190,5116,5074,9821,369,99
"00CEFX","Wheatley",10838,5293,5545,10820,18,69
"00CFFA","Anston and Woodsetts",11361,5563,5798,11303,58,121
"00CFFB","Aston, Orgreave and Ulley",14904,7263,7641,14801,103,117
"00CFFC","Boston",9748,4693,5055,9551,197,112
"00CFFD","Bramley, Ravenfield and Wickersley",17447,8448,8999,17350,97,191
"00CFFE","Brampton, Melton and Wentworth",9113,4441,4672,9013,100,41
"00CFFF","Brinsworth, Catcliffe and Treeton",13230,6464,6766,13159,71,70
"00CFFG","Broom",9613,4672,4941,9518,95,124
"00CFFH","Central",8004,3999,4005,7955,49,30
"00CFFJ","Dalton, Hooton Roberts and Thrybergh",13546,6599,6947,13445,101,60
"00CFFK","Greasbrough",8404,4114,4290,8336,68,24
"00CFFL","Herringthorpe",9485,4445,5040,9413,72,14
"00CFFM","Kimberworth",11028,5341,5687,10931,97,55
"00CFFN","Kiveton Park",10503,5080,5423,10434,69,80
"00CFFP","Maltby",17247,8347,8900,17103,144,119
"00CFFQ","Park",9608,4770,4838,9367,241,60
"00CFFR","Rawmarsh East",9830,4778,5052,9795,35,36
"00CFFS","Rawmarsh West",10457,5135,5322,10321,136,44
"00CFFT","St. John's",11476,5626,5850,11366,110,90
"00CFFU","Swinton",11281,5463,5818,11172,109,69
"00CFFW","Thorpe Hesley",11285,5503,5782,11280,5,78
"00CFFX","Thurcroft and Whiston",9934,4799,5135,9854,80,49
"00CFFY","Wath",10671,5148,5523,10546,125,88
"00CGFA","Beauchief",18410,8843,9567,18306,104,164
"00CGFB","Birley",18519,8901,9618,18424,95,57
"00CGFC","Brightside",16495,8159,8336,16331,164,53
"00CGFD","Broomhill",18775,9191,9584,15462,3313,245
"00CGFE","Burngreave",13784,6879,6905,13299,485,46
"00CGFF","Castle",13688,7025,6663,13685,3,37
"00CGFG","Chapel Green",23082,11267,11815,22832,250,147
"00CGFH","Darnall",19640,9667,9973,19550,90,80
"00CGFJ","Dore",18483,8836,9647,18251,232,299
"00CGFK","Ecclesall",20155,9811,10344,20066,89,526
"00CGFL","Firth Park",16836,8185,8651,16546,290,44
"00CGFM","Hallam",18261,8763,9498,18147,114,349
"00CGFN","Handsworth",18664,8978,9686,18389,275,41
"00CGFP","Heeley",17841,8648,9193,17601,240,53
"00CGFQ","Hillsborough",18340,8852,9488,18268,72,79
"00CGFR","Intake",18133,8755,9378,17842,291,62
"00CGFS","Manor",11907,5683,6224,11804,103,21
"00CGFT","Mosborough",34711,16940,17771,34529,182,145
"00CGFU","Nether Edge",16980,8548,8432,16722,258,261
"00CGFW","Nether Shire",16006,7553,8453,15957,49,42
"00CGFX","Netherthorpe",16030,8167,7863,15800,230,61
"00CGFY","Norton",14468,6859,7609,14377,91,74
"00CGFZ","Owlerton",14885,7265,7620,14768,117,22
"00CGGA","Park",12813,6223,6590,12687,126,23
"00CGGB","Sharrow",17897,9291,8606,16624,1273,127
"00CGGC","Southey Green",14283,6969,7314,14223,60,28
"00CGGD","South Wortley",23442,11412,12030,23226,216,196
"00CGGE","Stocksbridge",13663,6609,7054,13525,138,95
"00CGGF","Walkley",17043,8351,8692,16971,72,67
"00CHFA","Bede",7122,3669,3453,7079,43,12
"00CHFB","Bensham",7487,3749,3738,6695,792,84
"00CHFC","Birtley",8021,3895,4126,7918,103,33
"00CHFD","Blaydon",8758,4189,4569,8695,63,30
"00CHFE","Chopwell and Rowlands Gill",9325,4505,4820,9325,0,59
"00CHFF","Chowdene",8324,3974,4350,8152,172,43
"00CHFG","Crawcrook and Greenside",9331,4480,4851,9217,114,47
"00CHFH","Deckham",7884,3783,4101,7813,71,21
"00CHFJ","Dunston",9633,4704,4929,9579,54,25
"00CHFK","Felling",7299,3489,3810,7139,160,10
"00CHFL","High Fell",8034,3782,4252,7848,186,14
"00CHFM","Lamesley",7812,3712,4100,7751,61,14
"00CHFN","Leam",9925,4760,5165,9888,37,14
"00CHFP","Low Fell",9496,4561,4935,9397,99,77
"00CHFQ","Pelaw and Heworth",8026,3782,4244,8026,0,28
"00CHFR","Ryton",9219,4411,4808,9150,69,61
"00CHFS","Saltwell",8141,4006,4135,8069,72,35
"00CHFT","Teams",9241,4495,4746,9144,97,18
"00CHFU","Whickham North",9976,4850,5126,9853,123,84
"00CHFW","Whickham South",10312,4993,5319,10303,9,160
"00CHFX","Winlaton",7545,3640,3905,7434,111,26
"00CHFY","Wrekendyke",10240,4979,5261,10228,12,39
"00CJFA","Benwell",7184,3406,3778,7096,88,19
"00CJFB","Blakelaw",11912,5754,6158,11871,41,58
"00CJFC","Byker",8200,4002,4198,8043,157,18
"00CJFD","Castle",11436,5505,5931,11399,37,123
"00CJFE","Dene",15498,7462,8036,14725,773,138
"00CJFF","Denton",9932,4652,5280,9874,58,38
"00CJFG","Elswick",8124,4048,4076,7920,204,31
"00CJFH","Fawdon",9972,4736,5236,9870,102,19
"00CJFJ","Fenham",11448,5439,6009,11069,379,71
"00CJFK","Grange",12031,5671,6360,11818,213,114
"00CJFL","Heaton",10503,5028,5475,10448,55,64
"00CJFM","Jesmond",11849,5867,5982,11491,358,191
"00CJFN","Kenton",10179,4921,5258,10141,38,91
"00CJFP","Lemington",10061,4826,5235,9959,102,22
"00CJFQ","Monkchester",8202,3903,4299,8190,12,11
"00CJFR","Moorside",10682,5229,5453,8564,2118,87
"00CJFS","Newburn",8632,4158,4474,8559,73,23
"00CJFT","Sandyford",11458,5764,5694,11291,167,47
"00CJFU","Scotswood",6533,3133,3400,6479,54,17
"00CJFW","South Gosforth",10266,4965,5301,10073,193,234
"00CJFX","Walker",7725,3796,3929,7610,115,4
"00CJFY","Walkergate",10209,4921,5288,10174,35,34
"00CJFZ","West City",6334,3354,2980,6093,241,13
"00CJGA","Westerhope",12669,6120,6549,12610,59,110
"00CJGB","Wingrove",10569,5078,5491,10532,37,89
"00CJGC","Woolsington",7928,3735,4193,7849,79,16
"00CKFA","Battle Hill",11780,5686,6094,11735,45,58
"00CKFB","Benton",8621,4071,4550,8485,136,80
"00CKFC","Camperdown",9559,4582,4977,9536,23,35
"00CKFD","Chirton",8334,4030,4304,8334,0,11
"00CKFE","Collingwood",9239,4413,4826,9238,0,26
"00CKFF","Cullercoats",9407,4432,4975,9333,74,75
"00CKFG","Holystone",13453,6492,6961,13351,102,89
"00CKFH","Howdon",7804,3735,4069,7751,53,17
"00CKFJ","Longbenton",5819,2729,3090,5815,4,12
"00CKFK","Monkseaton",10469,4900,5569,10320,149,134
"00CKFL","North Shields",10652,5079,5573,10373,279,73
"00CKFM","Northumberland",11466,5569,5897,11417,49,55
"00CKFN","Riverside",9766,4663,5103,9570,196,21
"00CKFP","St. Mary's",8907,4318,4589,8883,24,209
"00CKFQ","Seatonville",9705,4603,5102,9655,50,84
"00CKFR","Tynemouth",8667,4163,4504,8572,95,99
"00CKFS","Valley",10129,4859,5270,10040,89,36
"00CKFT","Wallsend",8821,4256,4565,8711,110,35
"00CKFU","Weetslade",9962,4793,5169,9935,27,68
"00CKFW","Whitley Bay",9099,4334,4765,8638,461,75
"00CLFA","All Saints",7507,3558,3949,7425,82,18
"00CLFB","Beacon and Bents",7591,3790,3801,7387,204,37
"00CLFC","Bede",7052,3419,3633,6926,126,16
"00CLFD","Biddick Hall",6934,3201,3733,6882,52,19
"00CLFE","Boldon Colliery",9029,4441,4588,9004,25,31
"00CLFF","Cleadon and East Boldon",9037,4404,4633,9023,14,111
"00CLFG","Cleadon Park",8070,3840,4230,8070,0,27
"00CLFH","Fellgate and Hedworth",8606,4145,4461,8583,23,40
"00CLFJ","Harton",7220,3372,3848,7172,48,15
"00CLFK","Hebburn Quay",8023,3921,4102,7912,111,28
"00CLFL","Hebburn South",5968,2928,3040,5925,43,11
"00CLFM","Horsley Hill",8043,3820,4223,7993,50,40
"00CLFN","Monkton",8386,3985,4401,8137,249,26
"00CLFP","Primrose",8437,4078,4359,8363,74,34
"00CLFQ","Rekendyke",7303,3710,3593,7224,79,19
"00CLFR","Tyne Dock and Simonside",5894,2911,2983,5872,22,9
"00CLFS","Westoe",8306,4151,4155,7938,368,49
"00CLFT","West Park",7206,3553,3653,7200,6,37
"00CLFU","Whitburn and Marsden",6664,3229,3435,6649,15,45
"00CLFW","Whiteleas",7509,3617,3892,7437,72,20
"00CMFA","Castletown",10322,4879,5443,10248,74,16
"00CMFB","Central",12398,6337,6061,9970,2428,23
"00CMFC","Colliery",9006,4305,4701,8901,105,18
"00CMFD","Eppleton",12218,5991,6227,12015,203,54
"00CMFE","Fulwell",10171,4864,5307,10147,24,61
"00CMFF","Grindon",9548,4534,5014,9548,0,22
"00CMFG","Hendon",10377,5122,5255,10122,255,59
"00CMFH","Hetton",11222,5437,5785,11102,120,48
"00CMFJ","Houghton",10127,4861,5266,10028,99,33
"00CMFK","Pallion",10693,5110,5583,10521,172,42
"00CMFL","Ryhope",13852,6676,7176,13736,116,43
"00CMFM","St. Chad's",10006,4750,5256,9918,88,67
"00CMFN","St. Michael's",10267,4977,5290,10215,52,110
"00CMFP","St. Peter's",10264,5110,5154,9971,293,56
"00CMFQ","Shiney Row",14047,6805,7242,13851,196,39
"00CMFR","Silksworth",12295,5936,6359,12216,79,36
"00CMFS","South Hylton",10317,4937,5380,10199,118,18
"00CMFT","Southwick",8690,4133,4557,8546,144,12
"00CMFU","Thorney Close",9938,4829,5109,9933,5,11
"00CMFW","Thornholme",10214,5279,4935,9910,304,66
"00CMFX","Town End Farm",9381,4573,4808,9329,52,10
"00CMFY","Washington East",14540,7075,7465,14439,101,79
"00CMFZ","Washington North",11335,5513,5822,11329,6,32
"00CMGA","Washington South",18058,8992,9066,18034,24,143
"00CMGB","Washington West",11521,5600,5921,11362,159,60
"00CNFA","Acock's Green",26271,12756,13515,26011,260,106
"00CNFB","Aston",26972,13357,13615,26740,232,88
"00CNFC","Bartley Green",21793,10156,11637,21499,294,103
"00CNFD","Billesley",26974,12937,14037,26715,259,145
"00CNFE","Bournville",24412,11508,12904,23997,415,184
"00CNFF","Brandwood",24530,11729,12801,24314,216,170
"00CNFG","Edgbaston",23527,11737,11790,20479,3048,308
"00CNFH","Erdington",23853,11484,12369,23360,493,115
"00CNFJ","Fox Hollies",24083,11716,12367,23987,96,138
"00CNFK","Hall Green",25921,12510,13411,25867,54,299
"00CNFL","Handsworth",25912,12880,13032,25685,227,210
"00CNFM","Harborne",21868,10306,11562,21563,305,253
"00CNFN","Hodge Hill",24825,11951,12874,24677,148,119
"00CNFP","Kingsbury",16480,7839,8641,16381,99,41
"00CNFQ","King's Norton",20729,9671,11058,20509,220,120
"00CNFR","Kingstanding",25702,12225,13477,25510,192,80
"00CNFS","Ladywood",23789,12064,11725,22213,1576,203
"00CNFT","Longbridge",30964,14732,16232,30745,219,96
"00CNFU","Moseley",22447,10981,11466,21941,506,367
"00CNFW","Nechells",27390,13455,13935,24848,2542,89
"00CNFX","Northfield",23042,11160,11882,22958,84,152
"00CNFY","Oscott",21660,10361,11299,21482,178,75
"00CNFZ","Perry Barr",23123,11109,12014,22275,848,127
"00CNGA","Quinton",19798,9514,10284,19698,100,155
"00CNGB","Sandwell",27614,13522,14092,27371,243,305
"00CNGC","Selly Oak",25792,12660,13132,25147,645,207
"00CNGD","Shard End",23154,10822,12332,23080,74,36
"00CNGE","Sheldon",20129,9663,10466,20073,56,68
"00CNGF","Small Heath",35102,17163,17939,34966,136,164
"00CNGG","Soho",25634,12611,13023,25057,577,130
"00CNGH","Sparkbrook",28311,14161,14150,28063,248,108
"00CNGJ","Sparkhill",30011,15014,14997,29723,288,232
"00CNGK","Stockland Green",23060,11323,11737,22889,171,77
"00CNGL","Sutton Four Oaks",28613,13776,14837,28403,210,528
"00CNGM","Sutton New Hall",32363,15571,16792,32190,173,385
"00CNGN","Sutton Vesey",28818,13871,14947,28491,327,531
"00CNGP","Washwood Heath",27822,13609,14213,27721,101,81
"00CNGQ","Weoley",21623,10191,11432,21290,333,117
"00CNGR","Yardley",22976,11171,11805,22691,285,93
"00CQFA","Bablake",15041,7219,7822,14866,175,106
"00CQFB","Binley and Willenhall",18296,8857,9439,18212,84,105
"00CQFC","Cheylesmore",13983,6924,7059,13842,141,121
"00CQFD","Earlsdon",16543,8278,8265,16059,484,296
"00CQFE","Foleshill",17968,9035,8933,17726,242,122
"00CQFF","Henley",17027,8124,8903,16794,233,89
"00CQFG","Holbrook",18427,8967,9460,18267,160,137
"00CQFH","Longford",17601,8675,8926,17374,227,84
"00CQFJ","Lower Stoke",15778,7820,7958,15594,184,110
"00CQFK","Radford",16901,8324,8577,16795,106,79
"00CQFL","St. Michael's",15413,8135,7278,14372,1041,99
"00CQFM","Sherbourne",16531,8363,8168,16424,107,102
"00CQFN","Upper Stoke",17069,8546,8523,17032,37,98
"00CQFP","Wainbody",16306,8089,8217,13058,3248,255
"00CQFQ","Westwood",14983,7471,7512,14311,672,100
"00CQFR","Whoberley",16537,8428,8109,16399,138,96
"00CQFS","Woodlands",18486,9028,9458,18424,62,159
"00CQFT","Wyken",17958,8832,9126,17833,125,139
"00CRFA","Amblecote",19170,9522,9648,19069,101,140
"00CRFB","Belle Vale and Hasbury",11728,5761,5967,11682,46,65
"00CRFC","Brierley Hill",9631,4685,4946,9602,29,21
"00CRFD","Brockmoor and Pensnett",14162,6969,7193,14024,138,43
"00CRFE","Castle and Priory",11393,5515,5878,11358,35,30
"00CRFF","Coseley East",12054,5919,6135,12001,53,30
"00CRFG","Coseley West",12101,5817,6284,11931,170,47
"00CRFH","Gornal",18542,9223,9319,18528,14,70
"00CRFJ","Halesowen North",11854,5800,6054,11846,8,49
"00CRFK","Halesowen South",11954,5728,6226,11762,192,137
"00CRFL","Hayley Green",11236,5502,5734,11202,34,87
"00CRFM","Kingswinford North and Wall Heath",12788,6202,6586,12586,202,110
"00CRFN","Kingswinford South",12435,6181,6254,12414,21,106
"00CRFP","Lye and Wollescote",12402,6118,6284,12290,112,40
"00CRFQ","Netherton and Woodside",9274,4623,4651,9131,143,29
"00CRFR","Norton",11943,5791,6152,11888,55,140
"00CRFS","Pedmore and Stourbridge East",12567,6307,6260,12068,499,195
"00CRFT","Quarry Bank and Cradley",14764,7306,7458,14728,36,28
"00CRFU","St. Andrews",12423,6119,6304,12279,144,37
"00CRFW","St. James's",11547,5680,5867,11265,282,47
"00CRFX","St. Thomas's",12702,6135,6567,12651,51,58
"00CRFY","Sedgley",11923,5795,6128,11802,121,119
"00CRFZ","Wollaston and Stourbridge West",11901,5771,6130,11787,114,92
"00CRGA","Wordsley",14661,7245,7416,14490,171,67
"00CSFA","Abbey",11405,5376,6029,11404,0,61
"00CSFB","Blackheath",12355,5976,6379,12246,109,40
"00CSFC","Bristnall",12454,5990,6464,12364,90,46
"00CSFD","Charlemont",11230,5438,5792,11199,31,59
"00CSFE","Cradley Heath and Old Hill",12450,5912,6538,12300,150,41
"00CSFF","Friar Park",11367,5475,5892,11367,0,15
"00CSFG","Great Barr",12409,5960,6449,12368,41,99
"00CSFH","Great Bridge",12535,6133,6402,12359,176,27
"00CSFJ","Greets Green and Lyng",10297,5045,5252,10200,97,47
"00CSFK","Hateley Heath",12324,6033,6291,12134,190,42
"00CSFL","Langley",12500,6043,6457,12375,125,44
"00CSFM","Newton",11384,5464,5920,11355,29,64
"00CSFN","Oldbury",10830,5325,5505,10765,65,51
"00CSFP","Old Warley",10936,5189,5747,10893,43,64
"00CSFQ","Princes End",12826,6249,6577,12768,58,33
"00CSFR","Rowley",12621,6187,6434,12588,33,28
"00CSFS","St. Pauls",11480,5601,5879,11453,27,59
"00CSFT","Smethwick",11004,5280,5724,10969,35,53
"00CSFU","Soho and Victoria",7327,3398,3929,7216,111,32
"00CSFW","Tipton Green",16011,7703,8308,15928,83,57
"00CSFX","Tividale",12328,5987,6341,12182,146,38
"00CSFY","Wednesbury North",12365,5981,6384,12157,208,50
"00CSFZ","Wednesbury South",11972,5706,6266,11942,30,46
"00CSGA","West Bromwich Central",10494,5046,5448,10231,263,69
"00CTFA","Bickenhill",13561,6600,6961,13365,196,147
"00CTFB","Castle Bromwich",11857,5803,6054,11857,0,90
"00CTFC","Chelmsley Wood",10927,5244,5683,10869,58,26
"00CTFD","Elmdon",9796,4745,5051,9793,3,46
"00CTFE","Fordbridge",8748,4258,4490,8697,51,15
"00CTFF","Kingshurst",8126,3828,4298,8119,7,19
"00CTFG","Knowle",10823,5292,5531,10730,93,312
"00CTFH","Lyndon",10004,4877,5127,9972,32,46
"00CTFJ","Meriden",11811,5810,6001,11777,34,221
"00CTFK","Olton",11508,5554,5954,11202,306,181
"00CTFL","Packwood",14523,7120,7403,14494,29,305
"00CTFM","St. Alphege",13966,6856,7110,13933,33,324
"00CTFN","Shirley East",11816,5677,6139,11770,46,145
"00CTFP","Shirley South",16905,8281,8624,16772,133,202
"00CTFQ","Shirley West",11802,5705,6097,11727,75,72
"00CTFR","Silhill",12401,5858,6543,12177,224,200
"00CTFS","Smith's Wood",10943,5175,5768,10925,18,20
"00CUFA","Aldridge Central and South",12267,5901,6366,12102,165,125
"00CUFB","Aldridge North and Walsall Wood",12874,6261,6613,12800,74,99
"00CUFC","Bentley and Darlaston North",13689,6607,7082,13565,124,64
"00CUFD","Birchills Leamore",13659,6661,6998,13659,0,41
"00CUFE","Blakenall",11950,5823,6127,11799,151,28
"00CUFF","Bloxwich East",11072,5254,5818,10832,240,29
"00CUFG","Bloxwich West",14816,7163,7653,14759,57,49
"00CUFH","Brownhills",12637,6256,6381,12524,113,48
"00CUFJ","Darlaston South",12252,5994,6258,12177,75,29
"00CUFK","Hatherton Rushall",13451,6447,7004,13268,183,101
"00CUFL","Paddock",13073,6323,6750,13036,37,246
"00CUFM","Palfrey",14596,7049,7547,14540,56,122
"00CUFN","Pelsall",14344,6959,7385,14276,68,65
"00CUFP","Pheasey",8935,4412,4523,8930,5,49
"00CUFQ","Pleck",10653,5175,5478,10414,239,100
"00CUFR","St. Matthew's",12214,5974,6240,11865,349,75
"00CUFS","Short Heath",11435,5615,5820,11368,67,69
"00CUFT","Streetly",13251,6485,6766,13211,40,164
"00CUFU","Willenhall North",12536,6129,6407,12485,51,70
"00CUFW","Willenhall South",13795,6701,7094,13727,68,52
"00CWFA","Bilston East",10741,5253,5488,10649,92,25
"00CWFB","Bilston North",13527,6704,6823,13481,46,87
"00CWFC","Blakenhall",11301,5619,5682,10940,361,140
"00CWFD","Bushbury",11289,5517,5772,11187,102,30
"00CWFE","East Park",10452,5179,5273,10407,45,27
"00CWFF","Ettingshall",10839,5369,5470,10750,89,52
"00CWFG","Fallings Park",10996,5300,5696,10937,59,34
"00CWFH","Graiseley",11691,5730,5961,11551,140,109
"00CWFJ","Heath Town",10876,5336,5540,10766,110,59
"00CWFK","Low Hill",12828,6143,6685,12750,78,54
"00CWFL","Merry Hill",11893,5667,6226,11862,31,118
"00CWFM","Oxley",12848,6279,6569,12720,128,52
"00CWFN","Park",12844,6367,6477,12305,539,168
"00CWFP","Penn",12392,5979,6413,12164,228,147
"00CWFQ","St. Peter's",14472,7291,7181,13460,1012,91
"00CWFR","Spring Vale",12588,6129,6459,12457,131,45
"00CWFS","Tettenhall Regis",12000,5802,6198,11822,178,123
"00CWFT","Tettenhall Wightwick",10832,5216,5616,10725,107,172
"00CWFU","Wednesfield North",10978,5485,5493,10939,39,45
"00CWFW","Wednesfield South",11195,5493,5702,11195,0,48
"00CXFA","Baildon",15569,7486,8083,15429,140,204
"00CXFB","Bingley",13675,6556,7119,13444,231,158
"00CXFC","Bingley Rural",15142,7281,7861,15061,81,154
"00CXFD","Bolton",13762,6620,7142,13692,70,83
"00CXFE","Bowling",17722,8494,9228,17535,187,59
"00CXFF","Bradford Moor",17497,8566,8931,17232,265,93
"00CXFG","Clayton",14491,6584,7907,13798,693,112
"00CXFH","Craven",15875,7510,8365,15554,321,182
"00CXFJ","Eccleshill",13278,6363,6915,13230,48,52
"00CXFK","Great Horton",16019,7716,8303,15941,78,133
"00CXFL","Heaton",16913,8197,8716,16391,522,190
"00CXFM","Idle",15985,7662,8323,15756,229,77
"00CXFN","Ilkley",13828,6390,7438,13337,491,307
"00CXFP","Keighley North",15464,7601,7863,15365,99,139
"00CXFQ","Keighley South",13180,6240,6940,13121,59,45
"00CXFR","Keighley West",16281,7829,8452,16019,262,179
"00CXFS","Little Horton",16431,7973,8458,15984,447,85
"00CXFT","Odsal",16454,7839,8615,16398,56,78
"00CXFU","Queensbury",17573,8453,9120,17388,185,89
"00CXFW","Rombalds",16043,7817,8226,15953,90,291
"00CXFX","Shipley East",13455,6549,6906,13441,14,50
"00CXFY","Shipley West",15032,7197,7835,14692,340,171
"00CXFZ","Thornton",12960,6145,6815,12830,130,80
"00CXGA","Toller",18951,9346,9605,18747,204,111
"00CXGB","Tong",13823,6495,7328,13583,240,39
"00CXGC","Undercliffe",14732,7127,7605,14453,279,75
"00CXGD","University",22640,11544,11096,20946,1694,168
"00CXGE","Wibsey",13447,6389,7058,13398,49,61
"00CXGF","Worth Valley",15546,7579,7967,15456,90,155
"00CXGG","Wyke",15897,7585,8312,15785,112,55
"00CYFA","Brighouse",9720,4673,5047,9664,56,86
"00CYFB","Calder Valley",11600,5578,6022,11507,93,154
"00CYFC","Elland",10710,5122,5588,10631,79,54
"00CYFD","Greetland and Stainland",12085,5808,6277,12003,82,132
"00CYFE","Hipperholme and Lightcliffe",10035,4884,5151,9915,120,116
"00CYFF","Illingworth",8952,4326,4626,8856,96,62
"00CYFG","Luddendenfoot",10899,5253,5646,10869,30,109
"00CYFH","Mixenden",9977,4797,5180,9959,18,37
"00CYFJ","Northowram and Shelf",10688,5181,5507,10672,16,105
"00CYFK","Ovenden",10488,4979,5509,10425,63,36
"00CYFL","Rastrick",10332,5059,5273,10165,167,92
"00CYFM","Ryburn",12000,5802,6198,11881,119,152
"00CYFN","St. John's",11292,5579,5713,11230,62,56
"00CYFP","Skircoat",11013,5316,5697,10765,248,143
"00CYFQ","Sowerby Bridge",9948,4843,5105,9916,32,66
"00CYFR","Todmorden",10285,4891,5394,10183,102,93
"00CYFS","Town",11909,5815,6094,11807,102,54
"00CYFT","Warley",10472,5107,5365,10431,41,78
"00CZFA","Almondbury",12841,6090,6751,12674,167,91
"00CZFB","Batley East",18805,9273,9532,18693,112,126
"00CZFC","Batley West",18910,9245,9665,18757,153,83
"00CZFD","Birkby",15093,7420,7673,14954,139,183
"00CZFE","Birstall and Birkenshaw",17312,8426,8886,17232,80,127
"00CZFF","Cleckheaton",14937,7189,7748,14785,152,80
"00CZFG","Colne Valley West",13540,6616,6924,13497,43,104
"00CZFH","Crosland Moor",15694,7600,8094,15536,158,126
"00CZFJ","Dalton",15924,7648,8276,15891,33,66
"00CZFK","Deighton",12890,6157,6733,12769,121,67
"00CZFL","Denby Dale",18014,8730,9284,17809,205,225
"00CZFM","Dewsbury East",15816,7539,8277,15547,269,67
"00CZFN","Dewsbury West",18767,9241,9526,18500,267,134
"00CZFP","Golcar",16912,8282,8630,16764,148,121
"00CZFQ","Heckmondwike",17943,8772,9171,17764,179,108
"00CZFR","Holme Valley North",15891,7720,8171,15774,117,169
"00CZFS","Holme Valley South",17247,8470,8777,17198,49,276
"00CZFT","Kirkburton",16773,8233,8540,15503,1270,319
"00CZFU","Lindley",16367,7834,8533,16124,243,202
"00CZFW","Mirfield",15712,7607,8105,15474,238,114
"00CZFX","Newsome",13950,6759,7191,13422,528,75
"00CZFY","Paddock",14875,7291,7584,14567,308,121
"00CZFZ","Spen",16342,7819,8523,16174,168,106
"00CZGA","Thornhill",18012,8871,9141,17645,367,130
"00DAFA","Aireborough",25617,12410,13207,25219,398,261
"00DAFB","Armley",22034,10926,11108,21469,565,72
"00DAFC","Barwick and Kippax",23504,11488,12016,23446,58,212
"00DAFD","Beeston",16454,7982,8472,16384,70,41
"00DAFE","Bramley",22298,10680,11618,21153,1145,63
"00DAFF","Burmantofts",18507,8724,9783,18396,111,51
"00DAFG","Chapel Allerton",18206,8528,9678,17993,213,103
"00DAFH","City and Holbeck",20676,10322,10354,20460,216,39
"00DAFJ","Cookridge",21405,10236,11169,21279,126,296
"00DAFK","Garforth and Swillington",23892,11544,12348,23554,338,192
"00DAFL","Halton",22742,11046,11696,22562,180,158
"00DAFM","Harehills",21052,10244,10808,20995,57,86
"00DAFN","Headingley",25945,12905,13040,25242,703,108
"00DAFP","Horsforth",21562,10256,11306,20827,735,279
"00DAFQ","Hunslet",16155,7722,8433,15878,277,21
"00DAFR","Kirkstall",19964,9723,10241,19881,83,92
"00DAFS","Middleton",21002,10081,10921,20886,116,34
"00DAFT","Moortown",21473,10190,11283,21159,314,230
"00DAFU","Morley North",24812,12111,12701,24664,148,137
"00DAFW","Morley South",29239,14185,15054,29091,148,145
"00DAFX","North",22171,10576,11595,22083,88,394
"00DAFY","Otley and Wharfedale",24496,11902,12594,24343,153,337
"00DAFZ","Pudsey North",22835,11068,11767,22697,138,156
"00DAGA","Pudsey South",22178,10587,11591,21921,257,103
"00DAGB","Richmond Hill",17704,8386,9318,17689,15,44
"00DAGC","Rothwell",21010,10114,10896,20848,162,122
"00DAGD","Roundhay",21823,10490,11333,21364,459,377
"00DAGE","Seacroft",17725,8312,9413,17630,95,33
"00DAGF","University",21364,10558,10806,20643,721,74
"00DAGG","Weetwood",20721,9892,10829,19828,893,240
"00DAGH","Wetherby",26473,13109,13364,25475,998,511
"00DAGJ","Whinmoor",17249,8302,8947,17132,117,96
"00DAGK","Wortley",23114,11155,11959,22943,171,64
"00DBFA","Castleford Ferry Fryston",12644,6061,6583,12578,66,42
"00DBFB","Castleford Glasshoughton",13557,6550,7007,13475,82,51
"00DBFC","Castleford Whitwood",12260,6030,6230,12083,177,24
"00DBFD","Crofton and Ackworth",15365,7591,7774,15209,156,158
"00DBFE","Featherstone",14175,6779,7396,14054,121,56
"00DBFF","Hemsworth",13965,6907,7058,13858,107,51
"00DBFG","Horbury",14983,7199,7784,14877,106,130
"00DBFH","Knottingley",13503,6542,6961,13368,135,58
"00DBFJ","Normanton and Sharlston",16222,7831,8391,16095,127,85
"00DBFK","Ossett",15788,7676,8112,15700,88,113
"00DBFL","Pontefract North",16226,7882,8344,16054,172,80
"00DBFM","Pontefract South",13523,6576,6947,13474,49,159
"00DBFN","South Elmsall",14983,7324,7659,14868,115,86
"00DBFP","South Kirkby",14095,6802,7293,14014,81,50
"00DBFQ","Stanley and Altofts",17781,8676,9105,17488,293,131
"00DBFR","Stanley and Wrenthorpe",19163,9349,9814,18812,351,144
"00DBFS","Wakefield Central",14767,7016,7751,14389,378,57
"00DBFT","Wakefield East",15572,7620,7952,15408,164,68
"00DBFU","Wakefield North",15419,7680,7739,14669,750,72
"00DBFW","Wakefield Rural",16028,7778,8250,15639,389,167
"00DBFX","Wakefield South",15153,7341,7812,14998,155,283
"00EBMA","Brinkburn",5116,2430,2686,5094,22,15
"00EBMB","Brus",5164,2471,2693,5094,70,15
"00EBMC","Dyke House",5996,2863,3133,5996,0,13
"00EBMD","Elwick",1612,796,816,1612,0,27
"00EBME","Fens",6139,2994,3145,6139,0,40
"00EBMF","Grange",6001,2907,3094,5867,134,80
"00EBMG","Greatham",2225,1089,1136,2185,40,18
"00EBMH","Hart",5375,2638,2737,5375,0,40
"00EBMJ","Jackson",5453,2600,2853,5453,0,18
"00EBMK","Owton",4798,2215,2583,4761,37,14
"00EBML","Park",5516,2638,2878,5452,64,65
"00EBMM","Rift House",5568,2649,2919,5479,89,51
"00EBMN","Rossmere",4756,2232,2524,4751,5,28
"00EBMP","St. Hilda",6488,3132,3356,6338,150,19
"00EBMQ","Seaton",6018,2931,3087,5889,129,36
"00EBMR","Stranton",4970,2373,2597,4922,48,12
"00EBMS","Throston",7416,3602,3814,7341,75,57
"00ECNC","Acklam",5665,2766,2899,5657,8,65
"00ECND","Ayresome",6661,3168,3493,6659,3,26
"00ECNE","Beckfield",4919,2374,2545,4891,28,17
"00ECNF","Beechwood",5458,2566,2892,5106,352,16
"00ECNG","Brookfield",5997,2869,3128,5968,29,61
"00ECNH","Clairville",5706,2713,2993,5560,146,23
"00ECNJ","Coulby Newham",8657,4045,4612,8520,137,65
"00ECNK","Gresham",8768,4290,4478,8750,18,20
"00ECNL","Hemlington",6059,2893,3166,6059,0,18
"00ECNM","Kader",5023,2414,2609,5023,0,57
"00ECNN","Ladgate",5745,2780,2965,5704,41,39
"00ECNP","Linthorpe",8170,3948,4222,8030,140,122
"00ECNQ","North Ormesby and Brambles Farm",6533,3065,3468,6515,18,16
"00ECNR","Marton",4866,2371,2495,4866,0,60
"00ECNS","Marton West",5210,2529,2681,5178,32,79
"00ECNT","Middlehaven",4070,2085,1985,4024,46,11
"00ECNU","Nunthorpe",4705,2305,2400,4657,48,125
"00ECNW","Pallister",6025,2754,3271,5987,38,13
"00ECNX","Park",5549,2710,2839,5358,191,41
"00ECNY","Park End",6442,2964,3478,6434,8,14
"00ECNZ","Stainton and Thornton",2891,1357,1534,2804,87,19
"00ECPA","Thorntree",6080,2853,3227,6051,29,3
"00ECPB","University",5656,2875,2781,5148,508,20
"00EEMZ","Brotton",7113,3503,3610,7060,53,42
"00EENA","Coatham",5154,2521,2633,4926,228,19
"00EENB","Dormanstown",7269,3478,3791,7264,5,22
"00EENC","Eston",7523,3545,3978,7379,144,19
"00EEND","Grangetown",5887,2773,3114,5887,0,5
"00EENE","Guisborough",7404,3470,3934,7241,163,39
"00EENF","Hutton",7454,3702,3752,7454,0,149
"00EENG","Kirkleatham",7022,3259,3763,6970,52,38
"00EENH","Lockwood",2101,1042,1059,2079,22,10
"00EENJ","Loftus",7075,3501,3574,7015,60,40
"00EENK","Longbeck",6014,2946,3068,6014,0,57
"00EENL","Newcomen",4867,2334,2533,4842,25,17
"00EENM","Normanby",7150,3456,3694,7127,23,54
"00EENN","Ormesby",6393,3138,3255,6328,65,56
"00EENP","St Germain's",6434,3047,3387,6408,26,54
"00EENQ","Saltburn",5912,2842,3070,5678,234,63
"00EENR","Skelton",6396,3100,3296,6382,14,36
"00EENS","South Bank",8053,3881,4172,7944,109,14
"00EENT","Teesville",6862,3305,3557,6826,36,20
"00EENU","West Dyke",7527,3676,3851,7478,49,64
"00EENW","Westworth",4751,2296,2455,4667,84,73
"00EENX","Zetland",4771,2280,2491,4738,33,43
"00EFMA","Bishopsgarth",7588,3669,3919,7465,123,66
"00EFMB","Blue Hall",6088,2948,3140,6005,83,17
"00EFMC","Charltons",4812,2288,2524,4794,18,19
"00EFMD","Egglescliffe",7908,3852,4056,7873,35,163
"00EFME","Elm Tree",4507,2104,2403,4497,10,43
"00EFMF","Fairfield",4939,2402,2537,4895,44,72
"00EFMG","Glebe",6151,2963,3188,6151,0,103
"00EFMH","Grange",4028,1931,2097,4006,22,17
"00EFMJ","Grangefield",4927,2408,2519,4905,22,39
"00EFMK","Hardwick",4833,2293,2540,4805,28,15
"00EFML","Hartburn",6608,3163,3445,6575,33,95
"00EFMM","Ingleby Barwick",16280,8272,8008,16049,231,156
"00EFMN","Mandale",6449,3126,3323,6449,0,29
"00EFMP","Marsh House",7838,3925,3913,7838,0,63
"00EFMQ","Mile House",5530,2606,2924,5451,79,13
"00EFMR","Newtown",5652,2718,2934,5613,39,13
"00EFMS","Northfield",4449,2160,2289,4449,0,47
"00EFMT","Norton",6756,3734,3022,5823,933,40
"00EFMU","Parkfield",5816,3015,2801,5654,162,37
"00EFMW","Portrack and Tilery",5249,2595,2654,5078,171,7
"00EFMX","Preston",2969,1436,1533,2896,73,58
"00EFMY","Roseworth",5416,2527,2889,5416,0,10
"00EFMZ","St. Aidan's",4707,2195,2512,4699,8,22
"00EFNA","St. Cuthbert's",5845,2751,3094,5733,112,30
"00EFNB","Stainsby",5585,2662,2923,5564,21,38
"00EFNC","Victoria",5544,2669,2875,5415,129,21
"00EFND","Village",5042,2429,2613,4951,91,29
"00EFNE","Whitton",4602,2283,2319,4564,38,83
"00EFNF","Wolviston",3611,1759,1852,3567,44,33
"00EFNG","Yarm",8679,4240,4439,8603,76,207
"00EHNC","Bank Top",3754,1780,1974,3647,107,17
"00EHND","Central",3611,1800,1811,3458,153,13
"00EHNE","Cockerton East",5081,2425,2656,5078,3,21
"00EHNF","Cockerton West",4180,1932,2248,4148,32,13
"00EHNG","College",3732,1749,1983,3585,147,108
"00EHNH","Eastbourne",5090,2463,2627,5090,0,17
"00EHNJ","Faverdale",1516,758,758,1516,0,9
"00EHNK","Harrowgate Hill",5894,2938,2956,5855,39,33
"00EHNL","Haughton East",4133,1949,2184,4082,51,26
"00EHNM","Haughton North",3465,1679,1786,3450,15,53
"00EHNN","Haughton West",5513,2622,2891,5440,73,37
"00EHNP","Heighington and Coniscliffe",2953,1455,1498,2914,39,46
"00EHNQ","Hummersknott",3584,1677,1907,3476,108,77
"00EHNR","Hurworth",3404,1644,1760,3364,40,66
"00EHNS","Lascelles",3518,1690,1828,3410,108,17
"00EHNT","Lingfield",3538,1694,1844,3515,23,17
"00EHNU","Middleton St George",3818,1805,2013,3527,291,53
"00EHNW","Mowden",3645,1741,1904,3645,0,58
"00EHNX","North Road",6054,2873,3181,5994,60,27
"00EHNY","Northgate",4421,2245,2176,4164,257,23
"00EHNZ","Park East",6061,2891,3170,6014,47,51
"00EHPA","Park West",3506,1607,1899,3446,60,62
"00EHPB","Pierremont",5534,2644,2890,5503,31,34
"00EHPC","Sadberge and Whessoe",1833,899,934,1833,0,43
"00ETMY","Appleton",6390,3021,3369,6319,71,37
"00ETMZ","Beechwood",3984,1928,2056,3984,0,62
"00ETNA","Birchfield",4449,2218,2231,4449,0,56
"00ETNB","Broadheath",6448,3140,3308,6392,56,37
"00ETNC","Castlefields",6429,3189,3240,6393,36,23
"00ETND","Daresbury",3906,1947,1959,3891,15,46
"00ETNE","Ditton",6249,3041,3208,6184,65,39
"00ETNF","Farnworth",5908,2897,3011,5821,87,64
"00ETNG","Grange",6865,3323,3542,6800,65,30
"00ETNH","Hale",1898,944,954,1898,0,27
"00ETNJ","Halton Brook",6597,3184,3413,6547,50,37
"00ETNK","Halton Lea",6413,3016,3397,6239,174,29
"00ETNL","Halton View",6886,3400,3486,6790,96,52
"00ETNM","Heath",5507,2669,2838,5466,41,48
"00ETNN","Hough Green",7067,3359,3708,7015,52,30
"00ETNP","Kingsway",6096,2910,3186,6092,4,28
"00ETNQ","Mersey",6146,2912,3234,6064,82,20
"00ETNR","Norton North",6494,3157,3337,6457,37,40
"00ETNS","Norton South",7227,3403,3824,7216,11,40
"00ETNT","Riverside",4814,2327,2487,4743,71,17
"00ETNU","Windmill Hill",2435,1150,1285,2435,0,3
"00EUNB","Appleton",10477,5177,5300,10246,231,193
"00EUNC","Bewsey and Whitecross",9432,4613,4819,9316,116,18
"00EUND","Birchwood",11395,5651,5744,11368,27,98
"00EUNE","Burtonwood and Winwick",5595,2758,2837,5381,214,44
"00EUNF","Culcheth, Glazebury and Croft",11454,5925,5529,10563,891,127
"00EUNG","Fairfield and Howley",10571,5161,5410,10310,261,23
"00EUNH","Grappenhall and Thelwall",9377,4577,4800,9245,132,122
"00EUNJ","Great Sankey North",6435,3189,3246,6348,87,66
"00EUNK","Great Sankey South",10099,4987,5112,10099,0,114
"00EUNL","Hatton, Stretton and Walton",2919,1505,1414,2896,23,39
"00EUNM","Latchford East",7503,3601,3902,7410,93,18
"00EUNN","Latchford West",6478,3148,3330,6431,47,28
"00EUNP","Lymm",10552,5121,5431,10451,101,198
"00EUNQ","Orford",10950,5392,5558,10950,0,41
"00EUNR","Penketh and Cuerdley",8804,4290,4514,8678,126,97
"00EUNS","Poplars and Hulme",10840,5135,5705,10804,36,39
"00EUNT","Poulton North",10466,5045,5421,10130,336,86
"00EUNU","Poulton South",6553,3226,3327,6541,12,46
"00EUNW","Rixton and Woolston",9752,4840,4912,9693,59,111
"00EUNX","Stockton Heath",6396,3104,3292,6294,102,75
"00EUNY","Westbrook",6564,3240,3324,6435,129,49
"00EUNZ","Whittle Hall",8468,4192,4276,8408,60,73
"00EXMZ","Audley",8504,4220,4284,8393,111,67
"00EXNA","Bastwell",7390,3704,3686,7381,9,101
"00EXNB","Beardwood with Lammack",5485,2678,2807,5394,91,133
"00EXNC","Corporation Park",6644,3251,3393,6356,288,108
"00EXND","Earcroft",4253,2015,2238,4135,118,24
"00EXNE","East Rural",1923,959,964,1923,0,29
"00EXNF","Ewood",6592,3217,3375,6588,4,41
"00EXNG","Fernhurst",3957,1992,1965,3934,23,26
"00EXNH","Higher Croft",6962,3338,3624,6925,37,25
"00EXNJ","Little Harwood",6182,2975,3207,6117,65,43
"00EXNK","Livesey with Pleasington",6804,3337,3467,6728,76,84
"00EXNL","Marsh House",6023,2988,3035,6017,6,40
"00EXNM","Meadowhead",5887,2815,3072,5839,48,46
"00EXNN","Mill Hill",6350,3059,3291,6349,0,22
"00EXNP","North Turton with Tockholes",4190,2081,2109,4160,30,80
"00EXNQ","Queen's Park",5683,2802,2881,5602,81,34
"00EXNR","Roe Lee",5948,2869,3079,5940,8,67
"00EXNS","Shadsworth with Whitebirk",7651,3651,4000,7599,52,43
"00EXNT","Shear Brow",7402,3725,3677,7289,113,105
"00EXNU","Sudell",6806,3297,3509,6737,69,28
"00EXNW","Sunnyhurst",6343,3092,3251,6247,96,57
"00EXNX","Wensley Fold",6421,3232,3189,6223,198,34
"00EXNY","Whitehall",4070,2012,2058,3996,74,34
"00EYMZ","Anchorsholme",6551,3030,3521,6526,25,44
"00EYNA","Bispham",6121,2950,3171,5823,298,41
"00EYNB","Bloomfield",7289,3744,3545,6408,881,22
"00EYNC","Brunswick",7353,3571,3782,7328,25,50
"00EYND","Claremont",7430,3831,3599,6923,507,33
"00EYNE","Clifton",6938,3263,3675,6878,60,14
"00EYNF","Greenlands",6410,3013,3397,6405,5,43
"00EYNG","Hawes Side",7194,3399,3795,7179,15,31
"00EYNH","Highfield",6527,3077,3450,6480,47,44
"00EYNJ","Ingthorpe",6634,3130,3504,6591,43,23
"00EYNK","Layton",6960,3244,3716,6862,98,39
"00EYNL","Marton",6636,3226,3410,6622,14,35
"00EYNM","Norbreck",6308,2991,3317,6184,124,71
"00EYNN","Park",7044,3373,3671,6801,243,39
"00EYNP","Squires Gate",6382,2942,3440,6000,382,57
"00EYNQ","Stanley",6312,2987,3325,6297,15,45
"00EYNR","Talbot",6913,3658,3255,6252,661,37
"00EYNS","Tyldesley",7013,3360,3653,6874,139,48
"00EYNT","Victoria",6739,3227,3512,6674,65,25
"00EYNU","Warbreck",6704,3315,3389,6405,299,51
"00EYNW","Waterloo",6825,3411,3414,6115,710,46
"00FAMX","Avenue",12307,6072,6235,11980,327,104
"00FAMY","Beverley",8581,4218,4363,8492,89,64
"00FAMZ","Boothferry",12395,5976,6419,12370,25,54
"00FANA","Bransholme East",9991,4820,5171,9954,37,20
"00FANB","Bransholme West",8754,4216,4538,8675,79,16
"00FANC","Bricknell",7954,3849,4105,7860,94,80
"00FAND","Derringham",11438,5488,5950,11438,0,27
"00FANE","Drypool",12529,6329,6200,12438,91,32
"00FANF","Holderness",13242,6621,6621,13179,63,66
"00FANG","Ings",12143,5799,6344,12027,116,44
"00FANH","Kings Park",5905,2967,2938,5859,46,15
"00FANJ","Longhill",11385,5440,5945,11373,12,39
"00FANK","Marfleet",13211,6527,6684,12710,501,15
"00FANL","Myton",11908,6225,5683,11307,601,27
"00FANM","Newington",11297,5620,5677,11193,104,42
"00FANN","Newland",9830,4859,4971,9619,211,30
"00FANP","Orchard Park and Greenwood",13999,6694,7305,13983,16,29
"00FANQ","Pickering",11164,5339,5825,10996,168,23
"00FANR","St Andrew's",6781,3259,3522,6636,145,11
"00FANS","Southcoates East",8167,3854,4313,8167,0,13
"00FANT","Southcoates West",8186,3996,4190,7948,238,16
"00FANU","Sutton",12881,6297,6584,12689,192,35
"00FANW","University",9541,4666,4875,9064,477,41
"00FBND","Beverley Rural",13940,6920,7020,13618,322,270
"00FBNE","Bridlington Central and Old Town",10460,4971,5489,10372,88,65
"00FBNF","Bridlington North",12098,5706,6392,11948,150,101
"00FBNG","Bridlington South",14709,7040,7669,14093,616,100
"00FBNH","Cottingham North",8871,4246,4625,7678,1193,116
"00FBNJ","Cottingham South",8897,4215,4682,8314,583,74
"00FBNK","Dale",15032,7526,7506,14432,600,207
"00FBNL","Driffield and Rural",13074,6272,6802,12864,210,137
"00FBNM","East Wolds and Coastal",13201,6491,6710,13133,68,172
"00FBNN","Goole North",9668,4654,5014,9520,148,63
"00FBNP","Goole South",9073,4359,4714,8963,110,50
"00FBNQ","Hessle",14767,7108,7659,14477,290,135
"00FBNR","Howden",4454,2193,2261,4415,39,52
"00FBNS","Howdenshire",14010,7113,6897,13519,491,151
"00FBNT","Mid Holderness",13484,6737,6747,13462,22,149
"00FBNU","Minster and Woodmansey",14785,7143,7642,14601,184,91
"00FBNW","North Holderness",9731,4603,5128,9561,170,120
"00FBNX","Pocklington Provincial",15087,7336,7751,14778,309,204
"00FBNY","St Mary's",15566,7490,8076,15383,183,220
"00FBNZ","Snaith, Airmyn and Rawcliffe and Marshland",8738,4298,4440,8629,109,94
"00FBPA","South East Holderness",14461,7060,7401,14221,240,134
"00FBPB","South Hunsley",9067,4405,4662,9004,63,188
"00FBPC","South West Holderness",13293,6474,6819,13100,193,112
"00FBPD","Tranby",9921,4801,5120,9917,4,88
"00FBPE","Willerby and Kirk Ella",13679,6593,7086,13515,164,265
"00FBPF","Wolds Weighton",14047,7295,6752,13364,683,218
"00FCMQ","Croft Baker",11677,5598,6079,11583,94,38
"00FCMR","East Marsh",11749,5705,6044,11606,143,29
"00FCMS","Freshney",10048,4927,5121,10010,38,112
"00FCMT","Haverstoe",10269,5000,5269,10167,102,137
"00FCMU","Heneage",11563,5723,5840,11446,117,54
"00FCMW","Humberston and New Waltham",9941,4812,5129,9783,158,104
"00FCMX","Immingham",11804,5760,6044,11673,131,81
"00FCMY","Park",11809,5736,6073,11410,399,143
"00FCMZ","Scartho",9380,4531,4849,9274,106,92
"00FCNA","Sidney Sussex",12961,6375,6586,12776,185,48
"00FCNB","South",13066,6238,6828,13003,63,52
"00FCNC","Waltham",7036,3366,3670,6884,152,115
"00FCND","West Marsh",7781,3809,3972,7768,13,24
"00FCNE","Wolds",6717,3274,3443,6610,107,115
"00FCNF","Yarborough",12178,5852,6326,11997,181,72
"00FDMR","Ashby",9304,4560,4744,9252,52,59
"00FDMS","Axholme Central",6605,3237,3368,6597,8,107
"00FDMT","Axholme North",7227,3570,3657,7178,49,66
"00FDMU","Axholme South",6709,3281,3428,6625,84,115
"00FDMW","Barton",9485,4621,4864,9376,109,93
"00FDMX","Bottesford",11177,5518,5659,11170,7,145
"00FDMY","Brigg and Wolds",10421,5086,5335,10234,187,145
"00FDMZ","Broughton and Appleby",6316,3105,3211,6159,157,79
"00FDNA","Brumby",11698,5636,6062,11636,62,76
"00FDNB","Burringham and Gunness",3698,1801,1897,3590,108,10
"00FDNC","Burton upon Stather and Winterton",10798,5275,5523,10692,106,157
"00FDND","Crosby and Park",11738,5717,6021,11609,129,98
"00FDNE","Ferry",10180,5094,5086,10090,90,116
"00FDNF","Frodingham",7777,3758,4019,7709,68,35
"00FDNG","Kingsway with Lincoln Gardens",10270,4956,5314,10069,201,124
"00FDNH","Ridge",12089,6001,6088,11835,254,145
"00FDNJ","Town",7357,3555,3802,7254,103,62
"00FFNG","Acomb",7729,3779,3950,7696,33,66
"00FFNH","Bishopthorpe",3802,1819,1983,3795,7,73
"00FFNJ","Clifton",12017,5683,6334,11652,365,98
"00FFNK","Derwent",3540,1723,1817,3487,53,57
"00FFNL","Dringhouses and Woodthorpe",10733,5198,5535,10690,43,166
"00FFNM","Fishergate",7921,3905,4016,7492,429,73
"00FFNN","Fulford",2595,1209,1386,2489,106,34
"00FFNP","Guildhall",6676,3138,3538,6378,298,55
"00FFNQ","Haxby and Wigginton",12468,5886,6582,12292,176,230
"00FFNR","Heslington",4122,2107,2015,1114,3008,23
"00FFNS","Heworth",11743,5497,6246,11524,219,70
"00FFNT","Heworth Without",3786,1822,1964,3771,15,62
"00FFNU","Holgate",11564,5702,5862,11452,112,77
"00FFNW","Hull Road",8269,4010,4259,8195,74,60
"00FFNX","Huntington and New Earswick",12089,5728,6361,11963,126,111
"00FFNY","Micklegate",10994,5316,5678,10762,232,85
"00FFNZ","Osbaldwick",3149,1502,1647,3093,56,26
"00FFPA","Rural West York",10286,4942,5344,9966,320,240
"00FFPB","Skelton, Rawcliffe and Clifton Without",12160,5911,6249,12104,56,101
"00FFPC","Strensall",7862,3869,3993,7606,256,131
"00FFPD","Westfield",13690,6491,7199,13516,174,51
"00FFPE","Wheldrake",3899,1900,1999,3847,52,96
"00FKMX","Abbey",12375,5922,6453,11441,934,96
"00FKMY","Allestree",13018,6319,6699,13018,0,201
"00FKMZ","Alvaston",13686,6728,6958,13610,76,51
"00FKNA","Arboretum",13789,7065,6724,13433,356,105
"00FKNB","Blagreaves",12517,6033,6484,12471,46,113
"00FKNC","Boulton",13744,6670,7074,13695,49,47
"00FKND","Chaddesden",13178,6411,6767,13151,27,64
"00FKNE","Chellaston",12153,5907,6246,12004,149,133
"00FKNF","Darley",12152,6020,6132,10693,1459,140
"00FKNG","Derwent",13623,6611,7012,13550,73,33
"00FKNH","Littleover",12257,5941,6316,12016,241,227
"00FKNJ","Mackworth",13043,6264,6779,12700,343,49
"00FKNK","Mickleover",13529,6529,7000,13352,177,209
"00FKNL","Normanton",13494,6658,6836,13304,190,106
"00FKNM","Oakwood",13429,6599,6830,13364,65,73
"00FKNN","Sinfin",13782,6673,7109,13708,74,70
"00FKNP","Spondon",11939,5890,6049,11831,108,84
"00FNNF","Abbey",12713,6084,6629,12603,110,76
"00FNNG","Aylestone",10801,5177,5624,10615,186,51
"00FNNH","Beaumont Leys",13838,6615,7223,13566,272,96
"00FNNJ","Belgrave",10297,4863,5434,10258,39,155
"00FNNK","Braunstone Park and Rowley Fields",16614,7787,8827,16484,130,63
"00FNNL","Castle",13465,6952,6513,11392,2073,82
"00FNNM","Charnwood",10664,5106,5558,10580,84,57
"00FNNN","Coleman",12099,5876,6223,12051,48,117
"00FNNP","Evington",9788,4560,5228,9678,110,155
"00FNNQ","Eyres Monsell",11229,5259,5970,11148,81,23
"00FNNR","Fosse",10735,5326,5409,10689,46,76
"00FNNS","Freemen",9983,4668,5315,9262,721,35
"00FNNT","Humberstone and Hamilton",11893,5807,6086,11668,225,93
"00FNNU","Knighton",16265,7804,8461,15120,1145,315
"00FNNW","Latimer",11583,5509,6074,11547,36,186
"00FNNX","New Parks",16022,7467,8555,15882,140,44
"00FNNY","Rushey Mead",15134,7320,7814,15060,74,275
"00FNNZ","Spinney Hills",21249,10427,10822,21217,32,184
"00FNPA","Stoneygate",17068,8479,8589,16856,212,231
"00FNPB","Thurncourt",9936,4701,5235,9828,108,76
"00FNPC","Westcotes",8653,4202,4451,8306,347,43
"00FNPD","Western Park",9892,4793,5099,9584,308,117
"00FPMS","Braunston and Belton",1263,616,647,1245,18,34
"00FPMT","Cottesmore",2941,1570,1371,2649,292,45
"00FPMU","Exton",1736,1032,704,1392,344,27
"00FPMW","Greetham",1679,1106,573,1129,550,30
"00FPMX","Ketton",2469,1206,1263,2394,75,55
"00FPMY","Langham",1042,510,532,1042,0,15
"00FPMZ","Lyddington",1318,651,667,1314,4,48
"00FPNA","Martinsthorpe",1146,551,595,1112,34,38
"00FPNB","Normanton",3019,1609,1410,2770,249,54
"00FPNC","Oakham North East",2811,1347,1464,2396,415,46
"00FPND","Oakham North West",3035,1506,1529,2948,87,18
"00FPNE","Oakham South East",2059,1004,1055,2050,9,54
"00FPNF","Oakham South West",2248,1079,1169,2248,0,50
"00FPNG","Ryhall and Casterton",2661,1310,1351,2659,3,50
"00FPNH","Uppingham",3947,2084,1863,3313,634,53
"00FPNJ","Whissendine",1189,572,617,1189,0,37
"00FYNE","Arboretum",10284,5448,4836,9853,431,40
"00FYNF","Aspley",15689,7528,8161,15689,0,33
"00FYNG","Basford",15113,7227,7886,14863,250,51
"00FYNH","Berridge",16122,8179,7943,15544,578,77
"00FYNJ","Bestwood",15321,7391,7930,15201,120,28
"00FYNK","Bilborough",16044,7694,8350,15934,110,30
"00FYNL","Bridge",9084,4745,4339,8994,90,35
"00FYNM","Bulwell",15755,7553,8202,15552,203,39
"00FYNN","Bulwell Forest",13825,6861,6964,13672,153,84
"00FYNP","Clifton North",12813,6193,6620,12093,720,157
"00FYNQ","Clifton South",13648,6634,7014,13630,18,32
"00FYNR","Dales",13867,6887,6980,13848,19,76
"00FYNS","Dunkirk and Lenton",9932,5244,4688,9453,479,44
"00FYNT","Leen Valley",9191,4435,4756,9135,56,77
"00FYNU","Mapperley",14105,6965,7140,13594,511,112
"00FYNW","Radford and Park",14546,7941,6605,14010,536,61
"00FYNX","St Ann's",13270,6774,6496,13081,189,24
"00FYNY","Sherwood",15130,7308,7822,14443,687,105
"00FYNZ","Wollaton East and Lenton Abbey",9031,4593,4438,5274,3757,41
"00FYPA","Wollaton West",14218,6930,7288,14141,77,249
"00GANY","Aylestone",6117,2933,3184,5843,274,79
"00GANZ","Backbury",2940,1427,1513,2873,67,62
"00GAPA","Belmont",9464,4571,4893,9464,0,48
"00GAPB","Bircher",2790,1354,1436,2716,74,59
"00GAPC","Bringsty",2899,1479,1420,2839,60,69
"00GAPD","Bromyard",5788,2876,2912,5653,135,59
"00GAPE","Burghill, Holmer and Lyde",3251,1566,1685,3162,89,61
"00GAPF","Castle",3153,1612,1541,3115,38,77
"00GAPG","Central",2503,1184,1319,2445,58,38
"00GAPH","Credenhill",3273,1603,1670,3175,98,54
"00GAPJ","Frome",3193,1591,1602,3192,3,79
"00GAPK","Golden Cross with Weobley",3030,1454,1576,3028,0,44
"00GAPL","Golden Valley North",2901,1441,1460,2900,3,64
"00GAPM","Golden Valley South",2915,1447,1468,2885,30,71
"00GAPN","Hagley",3458,1718,1740,3422,36,63
"00GAPP","Hampton Court",2689,1321,1368,2673,16,54
"00GAPQ","Hollington",1950,960,990,1900,50,37
"00GAPR","Hope End",5732,2794,2938,5602,130,146
"00GAPS","Kerne Bridge",3005,1478,1527,2906,99,71
"00GAPT","Kington Town",3176,1543,1633,3096,80,34
"00GAPU","Ledbury",9221,4353,4868,9158,63,134
"00GAPW","Leominster North",5648,2727,2921,5585,63,42
"00GAPX","Leominster South",5466,2660,2806,5340,126,58
"00GAPY","Llangarron",3194,1561,1633,3132,62,64
"00GAPZ","Mortimer",3168,1585,1583,3150,18,50
"00GAQA","Old Gore",3014,1502,1512,2979,35,67
"00GAQB","Pembridge and Lyonshall with Titley",2932,1470,1462,2884,48,39
"00GAQC","Penyard",3059,1517,1542,3045,14,49
"00GAQD","Pontrilas",3403,1694,1709,3365,38,85
"00GAQE","Ross-on-Wye East",4592,2166,2426,4482,110,38
"00GAQF","Ross-on-Wye West",5493,2649,2844,5456,37,64
"00GAQG","St Martins and Hinton",10692,5147,5545,10643,49,64
"00GAQH","St Nicholas",6328,3123,3205,6222,106,50
"00GAQJ","Stoney Street",2803,1385,1418,2781,22,38
"00GAQK","Sutton Walls",3090,1534,1556,3090,0,62
"00GAQL","Three Elms",10474,5081,5393,10428,46,85
"00GAQM","Tupsley",9264,4460,4804,9202,62,172
"00GAQN","Upton",2769,1385,1384,2769,0,74
"00GAQP","Valletts",3334,1660,1674,3278,56,46
"00GAQQ","Wormsley Ridge",2700,1339,1361,2697,3,57
"00GFNM","Apley Castle",2891,1453,1438,2856,35,57
"00GFNN","Arleston",3180,1521,1659,3173,7,17
"00GFNP","Brookside",7150,3564,3586,7145,5,38
"00GFNQ","Church Aston and Lilleshall",2912,1406,1506,2805,107,71
"00GFNR","College",3070,1523,1547,2976,94,42
"00GFNS","Cuckoo Oak",5648,2770,2878,5601,47,30
"00GFNT","Dawley Magna",9598,4733,4865,9593,5,32
"00GFNU","Donnington",6222,2984,3238,6053,169,32
"00GFNW","Dothill",2670,1328,1342,2648,22,23
"00GFNX","Edgmond",3188,1721,1467,2715,473,74
"00GFNY","Ercall",2819,1358,1461,2751,68,43
"00GFNZ","Ercall Magna",2825,1425,1400,2698,127,36
"00GFPA","Hadley and Leegomery",10117,4971,5146,10103,14,41
"00GFPB","Haygate",2646,1247,1399,2646,0,26
"00GFPC","Horsehay and Lightmoor",2808,1373,1435,2776,32,18
"00GFPD","Ironbridge Gorge",2417,1207,1210,2358,59,25
"00GFPE","Ketley and Oakengates",9050,4418,4632,8998,52,35
"00GFPF","Lawley and Overdale",4632,2297,2335,4626,6,25
"00GFPG","Madeley",5279,2492,2787,5238,41,52
"00GFPH","Malinslee",5977,2882,3095,5977,0,17
"00GFPJ","Muxton",5818,2870,2948,5818,0,37
"00GFPK","Newport East",2762,1402,1360,2762,0,38
"00GFPL","Newport North",2866,1436,1430,2793,73,37
"00GFPM","Newport South",2627,1284,1343,2587,40,38
"00GFPN","Newport West",2760,1344,1416,2714,46,48
"00GFPP","Park",2654,1305,1349,2594,60,24
"00GFPQ","Priorslee",6501,3279,3222,6141,360,117
"00GFPR","St Georges",5645,2727,2918,5601,44,16
"00GFPS","Shawbirch",3281,1636,1645,3281,0,38
"00GFPT","The Nedge",9593,4719,4874,9565,28,64
"00GFPU","Woodside",7061,3416,3645,7018,43,26
"00GFPW","Wrockwardine",4862,2411,2451,4844,18,69
"00GFPX","Wrockwardine Wood and Trench",6796,3357,3439,6791,5,42
"00GLMX","Abbey Green",11652,5570,6082,11481,171,39
"00GLMY","Bentilee and Townsend",11931,5779,6152,11874,57,21
"00GLMZ","Berryhill and Hanley East",10579,5093,5486,10531,48,15
"00GLNA","Blurton",11741,5705,6036,11686,55,28
"00GLNB","Burslem North",12127,5916,6211,11988,139,37
"00GLNC","Burslem South",12071,5928,6143,11829,242,32
"00GLND","Chell and Packmoor",11803,5721,6082,11679,124,30
"00GLNE","East Valley",11362,5442,5920,11286,76,35
"00GLNF","Fenton",12194,5930,6264,12188,6,25
"00GLNG","Hanley West and Shelton",10594,5217,5377,9344,1250,46
"00GLNH","Hartshill and Penkhull",11944,5791,6153,11550,394,64
"00GLNJ","Longton North",13758,6778,6980,13715,43,28
"00GLNK","Longton South",13366,6417,6949,13117,249,46
"00GLNL","Meir Park and Sandon",13331,6571,6760,13282,49,99
"00GLNM","Northwood and Birches Head",12025,5953,6072,12001,24,41
"00GLNN","Norton and Bradeley",11157,5441,5716,11092,65,34
"00GLNP","Stoke and Trent Vale",12271,6017,6254,12223,48,45
"00GLNQ","Trentham and Hanford",12068,5878,6190,11837,231,121
"00GLNR","Tunstall",12381,5964,6417,12220,161,28
"00GLNS","Weston and Meir North",12281,6047,6234,12148,133,62
"00HANP","Abbey",5197,2507,2690,4913,284,45
"00HANQ","Bathavon North",7074,3395,3679,6949,125,130
"00HANR","Bathavon South",2976,1487,1489,2726,250,71
"00HANS","Bathavon West",2503,1184,1319,2076,427,45
"00HANT","Bathwick",4087,2014,2073,2368,1719,63
"00HANU","Chew Valley North",2307,1144,1163,2307,0,64
"00HANW","Chew Valley South",2254,1073,1181,2254,0,46
"00HANX","Clutton",2444,1230,1214,2412,32,30
"00HANY","Combe Down",5339,2529,2810,5281,58,88
"00HANZ","Farmborough",2613,1291,1322,2556,57,44
"00HAPA","High Littleton",2932,1447,1485,2868,64,27
"00HAPB","Keynsham East",5479,2676,2803,5410,69,90
"00HAPC","Keynsham North",5035,2410,2625,4955,80,37
"00HAPD","Keynsham South",5019,2338,2681,4917,102,26
"00HAPE","Kingsmead",5253,2582,2671,5131,122,49
"00HAPF","Lambridge",5201,2514,2687,5179,22,66
"00HAPG","Lansdown",4603,2223,2380,4339,264,136
"00HAPH","Lyncombe",5232,2548,2684,5148,84,110
"00HAPJ","Mendip",2751,1306,1445,2690,61,39
"00HAPK","Midsomer Norton North",5367,2686,2681,5354,13,40
"00HAPL","Midsomer Norton Redfield",5091,2494,2597,5050,41,39
"00HAPM","Newbridge",5596,2595,3001,5375,221,88
"00HAPN","Odd Down",5261,2509,2752,5261,0,43
"00HAPP","Oldfield",5412,2604,2808,5344,68,32
"00HAPQ","Paulton",4896,2438,2458,4822,74,48
"00HAPR","Peasedown",6306,3091,3215,6280,26,43
"00HAPS","Publow and Whitchurch",2400,1172,1228,2357,43,28
"00HAPT","Radstock",5276,2660,2616,5246,30,31
"00HAPU","Saltford",4153,2006,2147,4149,4,76
"00HAPW","Southdown",5864,2872,2992,5864,0,41
"00HAPX","Timsbury",2581,1242,1339,2510,71,31
"00HAPY","Twerton",5432,2597,2835,5347,85,18
"00HAPZ","Walcot",5641,2849,2792,5637,4,67
"00HAQA","Westfield",5591,2758,2833,5571,20,33
"00HAQB","Westmoreland",5251,2557,2694,5207,44,33
"00HAQC","Weston",5275,2430,2845,5210,65,76
"00HAQD","Widcombe",5348,2685,2663,5173,175,84
"00HBNM","Ashley",11168,5524,5644,11066,102,96
"00HBNN","Avonmouth",12177,5930,6247,12047,130,46
"00HBNP","Bedminster",10758,5270,5488,10684,74,37
"00HBNQ","Bishopston",11996,6133,5863,11792,204,123
"00HBNR","Bishopsworth",11339,5423,5916,11270,69,30
"00HBNS","Brislington East",11511,5565,5946,11409,102,59
"00HBNT","Brislington West",10636,5222,5414,10558,78,36
"00HBNU","Cabot",9604,4964,4640,8082,1522,71
"00HBNW","Clifton",10293,5399,4894,9240,1053,142
"00HBNX","Clifton East",9359,4739,4620,8723,636,91
"00HBNY","Cotham",10902,5390,5512,10643,259,115
"00HBNZ","Easton",10716,5199,5517,10648,68,51
"00HBPA","Eastville",10852,5291,5561,10678,174,54
"00HBPB","Filwood",11501,5462,6039,11443,58,20
"00HBPC","Frome Vale",10756,4992,5764,10103,653,81
"00HBPD","Hartcliffe",11253,5461,5792,11238,15,23
"00HBPE","Henbury",9498,4365,5133,9352,146,57
"00HBPF","Hengrove",11331,5425,5906,11274,57,27
"00HBPG","Henleaze",10506,5060,5446,10265,241,257
"00HBPH","Hillfields",12343,5947,6396,12265,78,41
"00HBPJ","Horfield",11268,5569,5699,11060,208,65
"00HBPK","Kingsweston",10844,5083,5761,10796,48,69
"00HBPL","Knowle",10881,5297,5584,10815,66,59
"00HBPM","Lawrence Hill",10585,5318,5267,10313,272,42
"00HBPN","Lockleaze",11043,5462,5581,10990,53,37
"00HBPP","Redland",10841,5433,5408,10543,298,158
"00HBPQ","St George East",11348,5611,5737,11330,18,49
"00HBPR","St George West",10929,5287,5642,10726,203,21
"00HBPS","Southmead",11005,5272,5733,10936,69,35
"00HBPT","Southville",10098,4975,5123,9841,257,37
"00HBPU","Stockwood",10932,5229,5703,10755,177,57
"00HBPW","Stoke Bishop",9660,4719,4941,7411,2249,223
"00HBPX","Westbury-on-Trym",10348,4722,5626,9919,429,206
"00HBPY","Whitchurch Park",11061,5378,5683,11015,46,37
"00HBPZ","Windmill Hill",11273,5544,5729,11245,28,53
"00HCNP","Backwell",5455,2699,2756,5364,91,113
"00HCNQ","Banwell and Winscombe",8691,4266,4425,8513,178,140
"00HCNR","Blagdon and Churchill",3890,1887,2003,3846,44,96
"00HCNS","Clevedon Central",3076,1490,1586,2959,117,22
"00HCNT","Clevedon East",3442,1679,1763,3408,34,41
"00HCNU","Clevedon North",2547,1129,1418,2247,300,18
"00HCNW","Clevedon South",3294,1631,1663,3293,0,25
"00HCNX","Clevedon Walton",2837,1325,1512,2624,213,59
"00HCNY","Clevedon West",3306,1616,1690,3306,0,28
"00HCNZ","Clevedon Yeo",3455,1710,1745,3455,0,32
"00HCPA","Congresbury",3447,1663,1784,3414,33,69
"00HCPB","Easton-in-Gordano",2881,1483,1398,2805,76,72
"00HCPC","Gordano",2603,1290,1313,2597,6,56
"00HCPD","Hutton and Locking",5839,2841,2998,5839,0,77
"00HCPE","Kewstoke",3248,1652,1596,3181,67,48
"00HCPF","Nailsea East",6963,3436,3527,6901,62,185
"00HCPG","Nailsea North and West",9583,4596,4987,9543,40,135
"00HCPH","Pill",3433,1688,1745,3404,29,30
"00HCPJ","Portishead Central",1518,729,789,1518,0,11
"00HCPK","Portishead Coast",2808,1365,1443,2699,109,47
"00HCPL","Portishead East",3326,1656,1670,3326,0,43
"00HCPM","Portishead Redcliffe Bay",2975,1462,1513,2975,0,34
"00HCPN","Portishead South and North Weston",3129,1535,1594,3100,29,36
"00HCPP","Portishead West",3374,1650,1724,3360,14,59
"00HCPQ","Weston-super-Mare Central",5986,2954,3032,5448,538,21
"00HCPR","Weston-super-Mare Clarence and Uphill",8988,4238,4750,8348,640,86
"00HCPS","Weston-super-Mare East",9570,4657,4913,9522,48,51
"00HCPT","Weston-super-Mare Milton and Old Worle",9396,4520,4876,9376,20,98
"00HCPU","Weston-super-Mare North Worle",9933,4851,5082,9933,0,102
"00HCPW","Weston-super-Mare South",10416,4944,5472,10403,13,28
"00HCPX","Weston-super-Mare South Worle",9081,4426,4655,9059,22,50
"00HCPY","Weston-super-Mare West",8388,3926,4462,7607,781,81
"00HCPZ","Winford",2826,1404,1422,2816,10,48
"00HCQA","Wraxall and Long Ashton",6556,3228,3328,6469,87,103
"00HCQB","Wrington",3128,1489,1639,3089,39,47
"00HCQC","Yatton",9176,4517,4659,9066,110,133
"00HDNR","Almondsbury",3703,1826,1877,3596,107,68
"00HDNS","Alveston",2922,1427,1495,2894,28,65
"00HDNT","Bitton",3476,1683,1793,3436,40,29
"00HDNU","Boyd Valley",7475,3880,3595,7127,348,103
"00HDNW","Bradley Stoke  Baileys Court",4342,2198,2144,4342,0,29
"00HDNX","Bradley Stoke  Bowsland",8093,4147,3946,8093,0,39
"00HDNY","Bradley Stoke  Sherbourne",5370,2662,2708,5364,6,26
"00HDNZ","Charfield",3689,2010,1679,3409,280,53
"00HDPA","Chipping Sodbury",6382,3121,3261,6354,28,54
"00HDPB","Cotswold Edge",3526,1748,1778,3489,37,91
"00HDPC","Dodington",7396,3691,3705,7371,25,37
"00HDPD","Downend",10409,5021,5388,10296,113,111
"00HDPE","Filton",9861,4953,4908,9709,152,70
"00HDPF","Frampton Cotterell",6251,3134,3117,6226,25,95
"00HDPG","Hanham",10052,4808,5244,9939,113,68
"00HDPH","Kings Chase",10519,5125,5394,10348,171,49
"00HDPJ","Ladden Brook",3748,1857,1891,3684,64,63
"00HDPK","Longwell Green",7250,3561,3689,7164,86,69
"00HDPL","Oldland Common",6957,3394,3563,6923,34,54
"00HDPM","Parkwall",7916,3888,4028,7863,53,38
"00HDPN","Patchway",10465,5183,5282,10453,12,50
"00HDPP","Pilning and Severn Beach",3442,1740,1702,3427,15,26
"00HDPQ","Rodway",9918,4852,5066,9911,7,52
"00HDPR","Severn",3537,1761,1776,3464,73,83
"00HDPS","Siston",13753,6834,6919,13665,88,83
"00HDPT","Staple Hill",6823,3290,3533,6771,52,31
"00HDPU","Stoke Gifford",10951,5485,5466,10951,0,82
"00HDPW","Thornbury North",6951,3343,3608,6664,287,117
"00HDPX","Thornbury South",6696,3292,3404,6680,16,120
"00HDPY","Westerleigh",3216,1566,1650,3183,33,28
"00HDPZ","Winterbourne",9181,4503,4678,8648,533,137
"00HDQA","Woodstock",10731,5334,5397,10660,71,51
"00HDQB","Yate Central",7010,3439,3571,6966,44,22
"00HDQC","Yate North",7200,3499,3701,7029,171,70
"00HDQD","Yate West",6430,3186,3244,6402,28,32
"00HGMX","Budshead",12314,5930,6384,12170,144,105
"00HGMY","Compton",11597,5727,5870,11173,424,175
"00HGMZ","Devonport",14287,7451,6836,13392,895,29
"00HGNA","Drake",8831,4598,4233,7175,1656,37
"00HGNB","Efford and Lipson",13262,6407,6855,13187,75,55
"00HGNC","Eggbuckland",12537,6000,6537,12481,56,96
"00HGND","Ham",13260,6292,6968,13213,47,52
"00HGNE","Honicknowle",13795,6505,7290,13684,111,36
"00HGNF","Moor View",12340,5940,6400,11828,512,67
"00HGNG","Peverell",12788,6141,6647,12637,151,111
"00HGNH","Plympton Chaddlewood",8074,3978,4096,8074,0,72
"00HGNJ","Plympton Erle",8892,4259,4633,8689,203,88
"00HGNK","Plympton St Mary",12159,5841,6318,11880,279,137
"00HGNL","Plymstock Dunstone",12418,5935,6483,12280,138,158
"00HGNM","Plymstock Radford",11685,5597,6088,11571,114,115
"00HGNN","St Budeaux",12958,6229,6729,12861,97,32
"00HGNP","St Peter and the Waterfront",12276,6315,5961,11463,813,54
"00HGNQ","Southway",12548,6077,6471,12486,62,72
"00HGNR","Stoke",12146,5976,6170,11657,489,85
"00HGNS","Sutton and Mount Gould",12553,6373,6180,12455,98,49
"00HHMN","Berry Head-with-Furzeham",10157,4809,5348,9987,170,96
"00HHMP","Blatchcombe",10164,4870,5294,10161,3,65
"00HHMQ","Churston-with-Galmpton",6794,3218,3576,6677,117,91
"00HHMR","Clifton-with-Maidenway",7043,3383,3660,6958,85,64
"00HHMS","Cockington-with-Chelston",11118,5317,5801,10816,302,147
"00HHMT","Ellacombe",7360,3562,3798,7236,124,56
"00HHMU","Goodrington-with-Roselands",6873,3257,3616,6822,51,67
"00HHMW","Preston",10280,4843,5437,9933,347,109
"00HHMX","Roundham-with-Hyde",7097,3345,3752,6544,553,36
"00HHMY","St Marychurch",11351,5297,6054,10751,600,94
"00HHMZ","St Mary's-with-Summercombe",7300,3455,3845,7182,118,65
"00HHNA","Shiphay-with-the-Willows",8253,3980,4273,8211,42,72
"00HHNB","Tormohun",10935,5381,5554,10500,435,72
"00HHNC","Watcombe",7359,3460,3899,7339,20,51
"00HHND","Wellswood",7622,3596,4026,7028,594,95
"00HNMW","Boscombe East",9392,4495,4897,9288,104,65
"00HNMX","Boscombe West",7598,3879,3719,6802,796,50
"00HNMY","Central",7955,4047,3908,6924,1031,54
"00HNMZ","East Cliff and Springbourne",10061,4908,5153,9447,614,48
"00HNNA","East Southbourne and Tuckton",8877,4026,4851,8498,379,77
"00HNNB","Kinson North",9700,4569,5131,9665,35,36
"00HNNC","Kinson South",10229,4803,5426,10173,56,29
"00HNND","Littledown and Iford",9582,4593,4989,9330,252,158
"00HNNE","Moordown",9677,4726,4951,9669,8,81
"00HNNF","Queen's Park",9746,4656,5090,9395,351,93
"00HNNG","Redhill and Northbourne",9077,4355,4722,8998,79,52
"00HNNH","Strouden Park",8955,4207,4748,8868,87,86
"00HNNJ","Talbot and Branksome Woods",8122,3842,4280,7679,443,120
"00HNNK","Throop and Muscliff",8411,3994,4417,8354,57,71
"00HNNL","Wallisdown and Winton West",9318,4545,4773,9235,83,74
"00HNNM","West Southbourne",8583,4027,4556,8220,363,61
"00HNNN","Westbourne and West Cliff",8628,4112,4516,7986,642,55
"00HNNP","Winton East",9533,4650,4883,9505,28,74
"00HPMP","Alderney",11196,5352,5844,11095,101,45
"00HPMQ","Branksome East",5763,2740,3023,5395,368,48
"00HPMR","Branksome West",7035,3404,3631,7015,20,39
"00HPMS","Broadstone",10256,4899,5357,10164,92,223
"00HPMT","Canford Cliffs",7622,3517,4105,7186,436,162
"00HPMU","Canford Heath East",7375,3565,3810,7324,51,51
"00HPMW","Canford Heath West",7043,3433,3610,7043,0,109
"00HPMX","Creekmoor",9257,4458,4799,9239,18,62
"00HPMY","Hamworthy East",5456,2633,2823,5390,66,36
"00HPMZ","Hamworthy West",6749,3267,3482,6678,71,39
"00HPNA","Merley and Bearwood",10629,5285,5344,10201,428,196
"00HPNB","Newtown",11132,5340,5792,11126,6,57
"00HPNC","Oakdale",10949,5249,5700,10888,61,69
"00HPND","Parkstone",9593,4373,5220,9376,217,97
"00HPNE","Penn Hill",10293,4860,5433,10022,271,146
"00HPNF","Poole Town",7940,3680,4260,7564,376,65
"00HXMY","Abbey Meads",4288,2204,2084,4234,54,25
"00HXMZ","Blunsdon",3300,1680,1620,3254,46,67
"00HXNA","Central",8780,4731,4049,8622,158,59
"00HXNB","Covingham and Nythe",8569,4241,4328,8569,0,87
"00HXNC","Dorcan",8974,4465,4509,8966,8,95
"00HXND","Eastcott",9231,4881,4350,9110,121,73
"00HXNE","Freshbrook and Grange Park",10383,5199,5184,10382,3,120
"00HXNF","Gorse Hill and Pinehurst",9195,4631,4564,9151,44,27
"00HXNG","Haydon Wick",10211,5178,5033,10159,52,84
"00HXNH","Highworth",8347,4037,4310,8307,40,134
"00HXNJ","Moredon",9563,4706,4857,9487,76,58
"00HXNK","Old Town and Lawn",9058,4357,4701,8698,360,201
"00HXNL","Parks",9419,4452,4967,9388,31,19
"00HXNM","Penhill",6068,2856,3212,6068,0,11
"00HXNN","Ridgeway",2958,1460,1498,2905,53,74
"00HXNP","St Margaret",9367,4692,4675,9237,130,61
"00HXNQ","St Philip",9055,4430,4625,9026,29,61
"00HXNR","Shaw and Nine Elms",9608,4827,4781,9578,30,83
"00HXNS","Toothill and Westlea",7876,3888,3988,7876,0,60
"00HXNT","Walcot",6888,3344,3544,6888,0,39
"00HXNU","Western",9437,4743,4694,9437,0,34
"00HXNW","Wroughton and Chiseldon",9476,4558,4918,9307,169,152
"00JANB","Barnack",2613,1275,1338,2613,0,65
"00JANC","Bretton North",9483,4605,4878,9482,3,99
"00JAND","Bretton South",3206,1555,1651,3206,0,52
"00JANE","Central",8762,4388,4374,8715,47,87
"00JANF","Dogsthorpe",8753,4190,4563,8680,73,40
"00JANG","East",8424,4094,4330,8340,84,55
"00JANH","Eye and Thorney",5296,2615,2681,5276,20,49
"00JANJ","Fletton",7872,3862,4010,7841,31,48
"00JANK","Glinton and Wittering",6252,3184,3068,5934,318,119
"00JANL","Newborough",2292,1146,1146,2290,3,32
"00JANM","North",5125,2421,2704,5125,0,22
"00JANN","Northborough",2645,1305,1340,2620,25,25
"00JANP","Orton Longueville",10416,5035,5381,10320,96,76
"00JANQ","Orton Waterville",8238,4035,4203,8234,4,102
"00JANR","Orton with Hampton",3513,1732,1781,3489,24,44
"00JANS","Park",8141,3983,4158,7972,169,106
"00JANT","Paston",8213,3910,4303,8201,12,55
"00JANU","Ravensthorpe",6820,3278,3542,6817,3,40
"00JANW","Stanground Central",8579,4136,4443,8477,102,48
"00JANX","Stanground East",3057,1471,1586,3057,0,19
"00JANY","Walton",5437,2671,2766,5393,44,35
"00JANZ","Werrington North",7942,3844,4098,7936,6,88
"00JAPA","Werrington South",6670,3246,3424,6670,0,100
"00JAPB","West",8312,4029,4283,7950,362,212
"00KAMS","Barnfield",7032,3507,3525,7025,7,114
"00KAMT","Biscot",12957,6626,6331,12810,147,93
"00KAMU","Bramingham",7584,3770,3814,7561,23,81
"00KAMW","Challney",11819,5877,5942,11656,163,103
"00KAMX","Crawley",7113,3583,3530,7113,0,32
"00KAMY","Dallow",13154,6775,6379,13051,103,71
"00KAMZ","Farley",10986,5380,5606,10950,36,43
"00KANA","High Town",7062,3590,3472,7004,58,35
"00KANB","Icknield",7556,3707,3849,7497,59,82
"00KANC","Leagrave",11194,5487,5707,11109,85,54
"00KAND","Lewsey",12654,6165,6489,12626,28,51
"00KANE","Limbury",7675,3831,3844,7671,4,80
"00KANF","Northwell",8258,4015,4243,8212,46,51
"00KANG","Round Green",10868,5395,5473,10868,0,53
"00KANH","Saints",11724,5833,5891,11606,118,86
"00KANJ","South",10364,5381,4983,10177,187,43
"00KANK","Stopsley",7105,3570,3535,7105,0,41
"00KANL","Sundon Park",7585,3822,3763,7569,16,37
"00KANM","Wigmore",11681,5805,5876,11681,0,73
"00KFMP","Belfairs",8944,4232,4712,8903,41,67
"00KFMQ","Blenheim Park",9908,4711,5197,9855,53,68
"00KFMR","Chalkwell",9207,4356,4851,8372,835,132
"00KFMS","Eastwood Park",9332,4478,4854,9275,57,69
"00KFMT","Kursaal",8872,4315,4557,8670,202,32
"00KFMU","Leigh",9015,4231,4784,8986,29,74
"00KFMW","Milton",8990,4361,4629,8629,361,47
"00KFMX","Prittlewell",9478,4612,4866,9310,168,95
"00KFMY","St Laurence",9673,4599,5074,9663,10,61
"00KFMZ","St. Luke's",10453,5023,5430,10434,19,39
"00KFNA","Shoeburyness",9974,4820,5154,9954,20,61
"00KFNB","Southchurch",9467,4395,5072,9358,109,102
"00KFNC","Thorpe",8715,4177,4538,8690,25,133
"00KFND","Victoria",9346,4465,4881,9180,166,31
"00KFNE","Westborough",10196,5027,5169,10154,42,63
"00KFNF","West Leigh",8670,4142,4528,8591,79,118
"00KFNG","West Shoebury",10017,4805,5212,9871,146,114
"00KGMX","Aveley and Uplands",8381,4081,4300,8378,3,19
"00KGMY","Belhus",8702,4185,4517,8620,82,22
"00KGMZ","Chadwell St Mary",9631,4518,5113,9580,51,29
"00KGNA","Chafford and North Stifford",5618,2781,2837,5618,0,23
"00KGNB","Corringham and Fobbing",5710,2764,2946,5705,5,34
"00KGNC","East Tilbury",6402,3138,3264,6374,28,26
"00KGND","Grays Riverside",9332,4647,4685,9315,17,27
"00KGNE","Grays Thurrock",9161,4383,4778,9020,141,52
"00KGNF","Little Thurrock Blackshots",5943,2939,3004,5937,6,36
"00KGNG","Little Thurrock Rectory",5950,2951,2999,5950,0,48
"00KGNH","Ockendon",8973,4336,4637,8951,22,30
"00KGNJ","Orsett",5627,2787,2840,5559,68,50
"00KGNK","South Chafford",2968,1500,1468,2968,0,13
"00KGNL","Stanford East and Corringham Town",8884,4197,4687,8838,46,40
"00KGNM","Stanford-le-Hope West",6630,3291,3339,6613,17,29
"00KGNN","Stifford Clays",6215,2975,3240,6164,51,44
"00KGNP","The Homesteads",9115,4476,4639,9115,0,79
"00KGNQ","Tilbury Riverside and Thurrock Park",6185,3011,3174,6176,9,22
"00KGNR","Tilbury St Chads",5906,2860,3046,5906,0,12
"00KGNS","West Thurrock and South Stifford",7795,3849,3946,7795,0,25
"00LCNN","Chatham Central",14663,7153,7510,14539,124,80
"00LCNP","Cuxton and Halling",5268,2601,2667,5265,3,29
"00LCNQ","Gillingham North",14756,7221,7535,14659,97,56
"00LCNR","Gillingham South",15074,7435,7639,14909,165,79
"00LCNS","Hempstead and Wigmore",8215,4074,4141,8131,84,123
"00LCNT","Lordswood and Capstone",9495,4673,4822,9424,71,66
"00LCNU","Luton and Wayfield",13640,6725,6915,13609,31,61
"00LCNW","Peninsula",12697,6263,6434,12624,73,80
"00LCNX","Princes Park",10391,5136,5255,10391,0,55
"00LCNY","Rainham Central",12649,6242,6407,12570,79,157
"00LCNZ","Rainham North",8677,4157,4520,8653,24,55
"00LCPA","Rainham South",14076,6927,7149,14056,20,124
"00LCPB","River",6972,3830,3142,6263,709,51
"00LCPC","Rochester East",9592,4604,4988,9552,40,57
"00LCPD","Rochester South and Horsted",12410,6030,6380,12256,154,123
"00LCPE","Rochester West",9702,4876,4826,9028,674,97
"00LCPF","Strood North",13292,6599,6693,13168,124,115
"00LCPG","Strood Rural",12092,5940,6152,12008,84,101
"00LCPH","Strood South",14221,6966,7255,14209,12,65
"00LCPJ","Twydall",13282,6443,6839,13231,51,64
"00LCPK","Walderslade",9280,4533,4747,9280,0,78
"00LCPL","Watling",9044,4468,4576,8841,203,93
"00MAMW","Ascot",5460,2544,2916,4968,492,97
"00MAMX","Binfield with Warfield",8189,4101,4088,7973,216,117
"00MAMY","Bullbrook",5064,2482,2582,5053,11,60
"00MAMZ","Central Sandhurst",5295,2634,2661,5258,37,72
"00MANA","College Town",5905,3121,2784,5419,486,66
"00MANB","Crown Wood",8466,4263,4203,8460,6,42
"00MANC","Crowthorne",5200,2733,2467,4715,485,68
"00MAND","Great Hollands North",4281,2064,2217,4278,3,23
"00MANE","Great Hollands South",5711,2830,2881,5704,7,73
"00MANF","Hanworth",8851,4471,4380,8813,38,105
"00MANG","Harmans Water",7279,3599,3680,7266,13,75
"00MANH","Little Sandhurst and Wellington",5706,3187,2519,4909,797,114
"00MANJ","Old Bracknell",4678,2334,2344,4633,45,25
"00MANK","Owlsmoor",5408,2697,2711,5408,0,83
"00MANL","Priestwood and Garth",7386,3556,3830,7291,95,39
"00MANM","Warfield Harvest Ride",8121,4033,4088,8116,5,45
"00MANN","Wildridings and Central",4535,2222,2313,4459,76,36
"00MANP","Winkfield and Cranbourne",4082,2008,2074,4029,53,77
"00MBNJ","Aldermaston",2602,1357,1245,2456,146,67
"00MBNK","Basildon",2841,1407,1434,2778,63,103
"00MBNL","Birch Copse",8157,4069,4088,8146,11,90
"00MBNM","Bucklebury",5922,3077,2845,5308,614,198
"00MBNN","Burghfield",5894,2927,2967,5841,53,91
"00MBNP","Calcot",9093,4533,4560,9084,9,124
"00MBNQ","Chieveley",2710,1400,1310,2390,320,56
"00MBNR","Clay Hill",5705,2888,2817,5669,36,32
"00MBNS","Cold Ash",3206,1359,1847,2633,573,87
"00MBNT","Compton",3045,1549,1496,2994,51,53
"00MBNU","Downlands",2968,1461,1507,2949,19,65
"00MBNW","Falkland",5885,2882,3003,5880,5,157
"00MBNX","Greenham",4843,2366,2477,4824,19,81
"00MBNY","Hungerford",5559,2735,2824,5495,64,59
"00MBNZ","Kintbury",4898,2379,2519,4750,148,157
"00MBPA","Lambourn Valley",5445,2715,2730,5414,31,119
"00MBPB","Mortimer",5089,2445,2644,4978,111,107
"00MBPC","Northcroft",4881,2386,2495,4872,9,69
"00MBPD","Pangbourne",2981,1535,1446,2772,209,73
"00MBPE","Purley on Thames",6435,3213,3222,6388,47,120
"00MBPF","St Johns",5529,2756,2773,5393,136,113
"00MBPG","Speen",5653,2744,2909,5529,124,106
"00MBPH","Sulhamstead",2726,1365,1361,2718,8,55
"00MBPJ","Thatcham Central",6119,3003,3116,6102,17,74
"00MBPK","Thatcham North",5257,2586,2671,5212,45,44
"00MBPL","Thatcham South and Crookham",5074,2580,2494,4988,86,73
"00MBPM","Thatcham West",6374,3251,3123,6364,10,50
"00MBPN","Theale",2771,1357,1414,2716,55,24
"00MBPP","Victoria",3958,1939,2019,3877,81,20
"00MBPQ","Westwood",2863,1439,1424,2863,0,37
"00MCMR","Abbey",8228,4421,3807,8131,97,38
"00MCMS","Battle",9231,4809,4422,9159,72,56
"00MCMT","Caversham",9265,4608,4657,9262,3,67
"00MCMU","Church",10315,5102,5213,8560,1755,66
"00MCMW","Katesgrove",8389,4500,3889,8113,276,44
"00MCMX","Kentwood",9741,4964,4777,9697,44,102
"00MCMY","Mapledurham",3046,1527,1519,3040,6,84
"00MCMZ","Minster",9149,4551,4598,8845,304,55
"00MCNA","Norcot",9918,4949,4969,9853,65,70
"00MCNB","Park",9547,5002,4545,9493,54,117
"00MCNC","Peppard",9277,4542,4735,9163,114,148
"00MCND","Redlands",9393,4866,4527,8244,1149,87
"00MCNE","Southcote",8486,3982,4504,8379,107,55
"00MCNF","Thames",9365,4508,4857,9131,234,181
"00MCNG","Tilehurst",9670,4750,4920,9654,16,94
"00MCNH","Whitley",10076,4995,5081,10042,34,40
"00MDMQ","Baylis and Stoke",10334,5244,5090,10331,3,95
"00MDMR","Britwell",9328,4567,4761,9278,50,42
"00MDMS","Central",10083,5038,5045,10026,57,87
"00MDMT","Chalvey",7412,3839,3573,7374,38,65
"00MDMU","Cippenham Green",8619,4296,4323,8608,11,42
"00MDMW","Cippenham Meadows",9294,4648,4646,9282,12,57
"00MDMX","Colnbrook with Poyle",5408,2661,2747,5386,22,34
"00MDMY","Farnham",8800,4428,4372,8800,0,99
"00MDMZ","Foxborough",6418,3236,3182,6410,8,36
"00MDNA","Haymill",9940,4957,4983,9911,29,65
"00MDNB","Kedermister",8696,4200,4496,8653,43,89
"00MDNC","Langley St Mary's",7447,3677,3770,7400,47,82
"00MDND","Upton",7423,3720,3703,7344,79,127
"00MDNE","Wexham Lea",9865,4807,5058,9719,146,66
"00MEMZ","Ascot and Cheapside",5065,2429,2636,4533,532,141
"00MENA","Belmont",7541,3666,3875,7504,37,108
"00MENB","Bisham and Cookham",6668,3269,3399,6475,193,144
"00MENC","Boyn Hill",6973,3449,3524,6946,27,159
"00MEND","Bray",6981,3417,3564,6870,111,167
"00MENE","Castle Without",6176,2951,3225,6022,154,101
"00MENF","Clewer East",4393,2205,2188,4086,307,44
"00MENG","Clewer North",7233,3545,3688,7227,6,99
"00MENH","Clewer South",5220,2546,2674,5220,0,53
"00MENJ","Cox Green",7203,3620,3583,7203,0,114
"00MENK","Datchet",4646,2235,2411,4631,15,81
"00MENL","Eton and Castle",3023,2167,856,1538,1485,35
"00MENM","Eton Wick",2299,1118,1181,2299,0,18
"00MENN","Furze Platt",7161,3501,3660,7141,20,115
"00MENP","Horton and Wraysbury",4624,2260,2364,4610,14,57
"00MENQ","Hurley and Walthams",6115,2993,3122,5987,128,136
"00MENR","Maidenhead Riverside",6987,3475,3512,6920,67,108
"00MENS","Old Windsor",4775,2357,2418,4762,13,96
"00MENT","Oldfield",7327,3580,3747,7285,42,102
"00MENU","Park",4965,2468,2497,4965,0,134
"00MENW","Pinkneys Green",6838,3301,3537,6754,84,132
"00MENX","Sunningdale",4875,2366,2509,4587,288,129
"00MENY","Sunninghill and South Ascot",6538,2977,3561,6193,345,173
"00MFNB","Arborfield",2042,1063,979,1917,125,53
"00MFNC","Barkham",4175,2450,1725,3247,928,73
"00MFND","Bulmershe and Whitegates",8386,4178,4208,8357,29,111
"00MFNE","Charvil",2990,1474,1516,2990,0,60
"00MFNF","Coronation",5871,2895,2976,5871,0,119
"00MFNG","Emmbrook",7574,3755,3819,7552,22,206
"00MFNH","Evendons",8963,4418,4545,8899,64,194
"00MFNJ","Finchampstead North",5606,2779,2827,5592,14,114
"00MFNK","Finchampstead South",5730,2823,2907,5687,43,141
"00MFNL","Hawkedon",9139,4586,4553,9021,118,103
"00MFNM","Hillside",9120,4620,4500,8770,350,208
"00MFNN","Hurst",2803,1406,1397,2803,0,49
"00MFNP","Loddon",8947,4455,4492,8947,0,83
"00MFNQ","Maiden Erlegh",9623,4934,4689,8583,1040,145
"00MFNR","Norreys",8138,3880,4258,8064,74,150
"00MFNS","Remenham, Wargrave and Ruscombe",5484,2687,2797,5358,126,137
"00MFNT","Shinfield North",2429,1178,1251,2411,18,31
"00MFNU","Shinfield South",5039,2534,2505,4985,54,60
"00MFNW","Sonning",2838,1410,1428,2820,18,49
"00MFNX","South Lake",5996,2940,3056,5388,608,86
"00MFNY","Swallowfield",2629,1317,1312,2539,90,48
"00MFNZ","Twyford",5421,2649,2772,5387,34,88
"00MFPA","Wescott",5250,2569,2681,5088,162,113
"00MFPB","Winnersh",7939,3977,3962,7851,88,155
"00MFPC","Wokingham Without",8097,4141,3956,7696,401,179
"00MGNB","Bletchley and Fenny Stratford",11234,5647,5587,11149,85,80
"00MGNC","Bradwell",12445,6208,6237,12439,6,109
"00MGND","Campbell Park",12980,6525,6455,12923,57,123
"00MGNE","Danesborough",4002,1962,2040,3938,64,70
"00MGNF","Denbigh",7608,3704,3904,7580,28,66
"00MGNG","Eaton Manor",8083,3960,4123,8057,26,48
"00MGNH","Emerson Valley",10756,5283,5473,10693,63,73
"00MGNJ","Furzton",8014,3948,4066,8010,4,69
"00MGNK","Hanslope Park",3988,1988,2000,3986,0,47
"00MGNL","Linford North",8633,4265,4368,8633,0,119
"00MGNM","Linford South",8279,4123,4156,8153,126,114
"00MGNN","Loughton Park",12498,6465,6033,11810,688,125
"00MGNP","Middleton",5442,2679,2763,5431,11,69
"00MGNQ","Newport Pagnell North",7447,3677,3770,7326,121,107
"00MGNR","Newport Pagnell South",7292,3626,3666,7265,27,76
"00MGNS","Olney",8165,4020,4145,8066,99,138
"00MGNT","Sherington",3953,1951,2002,3935,18,90
"00MGNU","Stantonbury",8940,4442,4498,8930,10,100
"00MGNW","Stony Stratford",14287,7062,7225,14227,60,169
"00MGNX","Walton Park",13154,6578,6576,13098,56,106
"00MGNY","Whaddon",8598,4228,4370,8511,87,78
"00MGNZ","Wolverton",11038,5557,5481,11008,30,89
"00MGPA","Woughton",10221,4946,5275,10086,135,41
"00MLND","Brunswick and Adelaide",8897,4568,4329,8724,173,26
"00MLNE","Central Hove",8268,4056,4212,7965,303,33
"00MLNF","East Brighton",13558,6583,6975,13367,191,52
"00MLNG","Goldsmid",13670,6469,7201,13082,588,88
"00MLNH","Hangleton and Knoll",14299,6827,7472,14256,43,87
"00MLNJ","Hanover and Elm Grove",13768,6642,7126,13373,395,54
"00MLNK","Hollingbury and Stanmer",14456,6757,7699,11656,2800,61
"00MLNL","Moulsecoomb and Bevendean",15722,7531,8191,15162,560,39
"00MLNM","North Portslade",10327,4947,5380,10327,0,52
"00MLNN","Patcham",13883,6604,7279,13796,87,110
"00MLNP","Preston Park",13354,6475,6879,13189,165,130
"00MLNQ","Queen's Park",13130,6704,6426,12838,292,77
"00MLNR","Regency",8510,4637,3873,8076,434,41
"00MLNS","Rottingdean Coastal",12468,5811,6657,11791,677,129
"00MLNT","St. Peter's and North Laine",13804,6910,6894,13650,154,43
"00MLNU","South Portslade",9237,4480,4757,9162,75,40
"00MLNW","Stanford",10056,4896,5160,9855,201,184
"00MLNX","Westbourne",9099,4131,4968,8335,764,58
"00MLNY","Wish",8377,3882,4495,8247,130,99
"00MLNZ","Withdean",13387,6374,7013,13242,145,176
"00MLPA","Woodingdean",9547,4613,4934,9526,21,64
"00MRMP","Baffins",13850,6784,7066,13608,242,50
"00MRMQ","Central Southsea",14125,7230,6895,14085,40,67
"00MRMR","Charles Dickens",15256,7233,8023,13273,1983,36
"00MRMS","Copnor",13303,6658,6645,13296,7,74
"00MRMT","Cosham",13134,6291,6843,12919,215,75
"00MRMU","Drayton and Farlington",12302,5922,6380,12155,147,146
"00MRMW","Eastney and Craneswater",12439,6213,6226,12021,418,130
"00MRMX","Fratton",13757,6772,6985,13713,44,37
"00MRMY","Hilsea",13210,6401,6809,13068,142,67
"00MRMZ","Milton",12810,6361,6449,12112,698,40
"00MRNA","Nelson",14556,7221,7335,14092,464,42
"00MRNB","Paulsgrove",14177,6977,7200,14141,36,36
"00MRNC","St Jude",11088,5703,5385,10463,625,78
"00MRND","St Thomas",12694,6276,6418,12159,535,89
"00MSMR","Bargate",11833,6216,5617,9788,2045,44
"00MSMS","Bassett",13139,6612,6527,11808,1331,146
"00MSMT","Bevois",13621,7279,6342,13340,281,65
"00MSMU","Bitterne",13177,6353,6824,13159,18,33
"00MSMW","Bitterne Park",13276,6691,6585,13162,114,86
"00MSMX","Coxford",14232,7002,7230,14232,0,63
"00MSMY","Freemantle",13468,7117,6351,13096,372,97
"00MSMZ","Harefield",13711,6650,7061,13619,92,48
"00MSNA","Millbrook",14502,7095,7407,14374,128,50
"00MSNB","Peartree",13633,6697,6936,13579,54,51
"00MSNC","Portswood",14384,7331,7053,13983,401,146
"00MSND","Redbridge",14432,7118,7314,14376,56,24
"00MSNE","Shirley",13369,6437,6932,13133,236,147
"00MSNF","Sholing",13590,6779,6811,13569,21,34
"00MSNG","Swaythling",13394,6835,6559,11762,1632,57
"00MSNH","Woolston",13684,6572,7112,13468,216,44
"00MWPC","Ashey",3026,1455,1571,2962,64,32
"00MWPD","Bembridge North",1771,787,984,1702,69,32
"00MWPE","Bembridge South",2077,955,1122,1978,99,28
"00MWPF","Binstead",3162,1500,1662,3115,47,52
"00MWPG","Brading and St Helens",3368,1626,1742,3357,11,47
"00MWPH","Brighstone and Calbourne",2490,1159,1331,2467,23,34
"00MWPJ","Carisbrooke East",2721,1315,1406,2704,17,35
"00MWPK","Carisbrooke West",2937,1392,1545,2895,42,32
"00MWPL","Central Rural",2773,1320,1453,2735,38,52
"00MWPM","Chale, Niton and Whitwell",2699,1292,1407,2689,10,39
"00MWPN","Cowes Castle East",2215,1034,1181,2146,69,30
"00MWPP","Cowes Castle West",2256,1081,1175,2232,24,39
"00MWPQ","Cowes Central",2558,1257,1301,2552,6,23
"00MWPR","Cowes Medina",2634,1224,1410,2609,25,7
"00MWPS","East Cowes North",1673,800,873,1655,18,18
"00MWPT","East Cowes South",3163,1507,1656,3086,77,16
"00MWPU","Fairlee",2849,1384,1465,2738,111,17
"00MWPW","Freshwater Afton",2817,1328,1489,2779,38,29
"00MWPX","Freshwater Norton",2543,1218,1325,2453,90,22
"00MWPY","Gurnard",1696,826,870,1696,0,29
"00MWPZ","Lake North",2646,1265,1381,2646,0,16
"00MWQA","Lake South",2304,1009,1295,2283,21,15
"00MWQB","Mount Joy",2718,1229,1489,2674,44,25
"00MWQC","Newchurch",2601,1263,1338,2589,12,58
"00MWQD","Newport North",2426,1150,1276,2408,18,10
"00MWQE","Newport South",2709,1242,1467,2686,23,16
"00MWQF","Northwood",2221,1080,1141,2221,0,21
"00MWQG","Osborne",2071,981,1090,2040,31,12
"00MWQH","Pan",2770,1328,1442,2723,47,5
"00MWQJ","Parkhurst",4428,2885,1543,3058,1370,15
"00MWQK","Ryde North East",3062,1474,1588,2847,215,26
"00MWQL","Ryde North West",2981,1405,1576,2864,117,30
"00MWQM","Ryde South East",3245,1538,1707,3226,19,16
"00MWQN","Ryde South West",2974,1399,1575,2940,34,36
"00MWQP","St Johns East",2671,1262,1409,2596,75,29
"00MWQQ","St Johns West",2860,1334,1526,2812,48,22
"00MWQR","Sandown North",3093,1458,1635,2885,208,27
"00MWQS","Sandown South",3456,1660,1796,3340,116,19
"00MWQT","Seaview and Nettlestone",2833,1337,1496,2788,45,59
"00MWQU","Shalfleet and Yarmouth",2325,1100,1225,2312,13,61
"00MWQW","Shanklin Central",2782,1307,1475,2694,88,26
"00MWQX","Shanklin North",2910,1370,1540,2871,39,22
"00MWQY","Shanklin South",3008,1447,1561,2861,147,28
"00MWQZ","Totland",2984,1394,1590,2772,212,42
"00MWRA","Ventnor East",3120,1497,1623,2994,126,31
"00MWRB","Ventnor West",3137,1481,1656,3038,99,30
"00MWRC","Wootton",3618,1717,1901,3581,37,38
"00MWRD","Wroxall and Godshill",3350,1625,1725,3348,0,22
"09UCGH","Ampthill",6897,3357,3540,6859,38,86
"09UCGJ","Arlesey",4741,2402,2339,4702,39,30
"09UCGK","Aspley Guise",2402,1174,1228,2375,27,41
"09UCGL","Biggleswade Holme",4701,2321,2380,4649,52,60
"09UCGM","Biggleswade Ivel",6999,3478,3521,6957,42,53
"09UCGN","Biggleswade Stratton",3683,1803,1880,3677,6,13
"09UCGP","Clifton and Meppershall",4279,2111,2168,4174,105,69
"09UCGQ","Cranfield",5438,2898,2540,5078,360,86
"09UCGR","Flitton, Greenfield and Pulloxhill",2062,1029,1033,2062,0,26
"09UCGS","Flitwick East",5383,2623,2760,5356,27,48
"09UCGT","Flitwick West",7550,3789,3761,7517,33,109
"09UCGU","Harlington",2322,1162,1160,2322,0,28
"09UCGW","Houghton, Haynes, Southill and Old Warden",3837,1945,1892,3813,24,63
"09UCGX","Langford and Henlow Village",4677,2353,2324,4648,29,54
"09UCGY","Marston",4829,2371,2458,4770,59,37
"09UCGZ","Maulden and Clophill",4602,2266,2336,4601,0,60
"09UCHA","Northill and Blunham",4414,2185,2229,4409,5,74
"09UCHB","Potton and Wensley",6842,3433,3409,6833,9,94
"09UCHC","Sandy Ivel",4317,2124,2193,4251,66,47
"09UCHD","Sandy Pinnacle",6570,3291,3279,6566,4,36
"09UCHE","Shefford, Campton and Gravenhurst",6897,3510,3387,6532,365,95
"09UCHF","Shillington, Stondon and Henlow Camp",4941,2531,2410,4780,161,91
"09UCHG","Silsoe",1729,869,860,1505,224,24
"09UCHH","Stotfold",6214,3075,3139,6214,0,65
"09UCHJ","Westoning and Tingrith",2150,1076,1074,2133,17,28
"09UCHK","Woburn",2548,1268,1280,2526,22,50
"09UDGE","Brickhill",8678,4342,4336,8652,26,167
"09UDGF","Bromham",7388,3690,3698,7349,39,158
"09UDGG","Carlton",2738,1370,1368,2738,0,90
"09UDGH","Castle",8259,4202,4057,8096,163,89
"09UDGJ","Cauldwell",8656,4290,4366,8547,109,63
"09UDGK","Clapham",5374,2649,2725,5330,44,57
"09UDGL","De Parys",5369,2752,2617,4607,762,87
"09UDGM","Eastcotts",2747,1327,1420,2747,0,13
"09UDGN","Goldington",8603,4081,4522,8588,15,72
"09UDGP","Great Barford",5183,2563,2620,5147,36,79
"09UDGQ","Harpur",8501,4163,4338,7593,908,65
"09UDGR","Harrold",2780,1368,1412,2730,50,46
"09UDGS","Kempston East",6067,3017,3050,6045,22,48
"09UDGT","Kempston North",5654,2766,2888,5595,59,67
"09UDGU","Kempston South",7712,3798,3914,7679,33,56
"09UDGW","Kingsbrook",9134,4403,4731,9087,47,41
"09UDGX","Newnham",5510,2707,2803,5503,7,57
"09UDGY","Oakley",2438,1204,1234,2432,6,71
"09UDGZ","Putnoe",8593,4206,4387,8564,29,162
"09UDHA","Queen's Park",7688,3881,3807,7662,26,61
"09UDHB","Riseley",2785,1397,1388,2765,20,55
"09UDHC","Roxton",2859,1435,1424,2853,6,45
"09UDHD","Sharnbrook",2600,1256,1344,2558,42,69
"09UDHE","Turvey",2767,1372,1395,2767,0,58
"09UDHF","Wilshamstead",4386,2139,2247,4338,48,30
"09UDHG","Wootton",5442,2688,2754,5442,0,60
"09UEGC","All Saints",4648,2235,2413,4604,44,53
"09UEGD","Barton-le-Clay",4793,2361,2432,4788,5,36
"09UEGE","Caddington, Hyde and Slip End",6051,3020,3031,6026,25,59
"09UEGF","Chiltern",4514,2249,2265,4484,30,81
"09UEGG","Dunstable Central",4429,2164,2265,4342,87,31
"09UEGH","Eaton Bray",2591,1264,1327,2583,8,35
"09UEGJ","Grovebury",5760,2891,2869,5757,3,61
"09UEGK","Heath and Reach",2015,1009,1006,2015,0,34
"09UEGL","Houghton Hall",6748,3311,3437,6685,63,41
"09UEGM","Icknield",6269,3149,3120,6205,64,53
"09UEGN","Kensworth and Totternhoe",4266,2081,2185,4234,32,72
"09UEGP","Linslade",4488,2219,2269,4428,60,80
"09UEGQ","Manshead",5103,2403,2700,5092,11,38
"09UEGR","Northfields",6832,3375,3457,6791,41,39
"09UEGS","Parkside",5179,2574,2605,5179,0,29
"09UEGT","Planets",4972,2480,2492,4972,0,41
"09UEGU","Plantation",5985,2936,3049,5867,118,123
"09UEGW","Southcott",6900,3474,3426,6900,0,157
"09UEGX","Stanbridge",2171,1070,1101,2137,34,42
"09UEGY","Streatley",2214,1105,1109,2204,10,12
"09UEGZ","Tithe Farm",5043,2463,2580,5043,0,33
"09UEHA","Toddington",5008,2486,2522,4993,15,51
"09UEHB","Watling",6658,3335,3323,6627,31,97
"11UBGR","Aston Clinton",9144,4525,4619,9143,3,180
"11UBGS","Aylesbury Central",2720,1358,1362,2654,66,37
"11UBGT","Bedgrove",9171,4488,4683,9102,69,165
"11UBGU","Bierton",1771,850,921,1721,50,17
"11UBGW","Brill",2724,1325,1399,2690,34,49
"11UBGX","Buckingham North",6429,3161,3268,6115,314,103
"11UBGY","Buckingham South",5143,2524,2619,5131,12,68
"11UBGZ","Cheddington",3243,1598,1645,3237,6,40
"11UBHA","Coldharbour",6363,3169,3194,6361,3,19
"11UBHB","Edlesborough",2977,1493,1484,2977,0,61
"11UBHC","Elmhurst and Watermead",9259,4583,4676,9152,107,69
"11UBHD","Gatehouse",5838,2897,2941,5744,94,32
"11UBHE","Great Brickhill",3029,1491,1538,3029,0,57
"11UBHF","Great Horwood",2807,1411,1396,2806,0,77
"11UBHG","Grendon Underwood",3039,1762,1277,2589,450,44
"11UBHH","Haddenham",8368,4043,4325,8286,82,195
"11UBHJ","Long Crendon",5358,2605,2753,5358,0,125
"11UBHK","Luffield Abbey",3138,1709,1429,2530,608,76
"11UBHL","Mandeville and Elm Farm",8313,4117,4196,8031,282,88
"11UBHM","Marsh Gibbon",2416,1200,1216,2393,23,52
"11UBHN","Newton Longville",2453,1212,1241,2453,0,51
"11UBHP","Oakfield",5802,3064,2738,5284,518,56
"11UBHQ","Pitstone",3024,1524,1500,3023,3,33
"11UBHR","Quainton",2467,1217,1250,2458,9,45
"11UBHS","Quarrendon",5897,2931,2966,5844,53,35
"11UBHT","Southcourt",5849,2848,3001,5844,5,19
"11UBHU","Steeple Claydon",2890,1432,1458,2890,0,48
"11UBHW","Stewkley",2955,1464,1491,2928,27,61
"11UBHX","Tingewick",3062,1528,1534,3062,0,80
"11UBHY","Waddesdon",2594,1284,1310,2594,0,45
"11UBHZ","Walton Court and Hawkslade",5961,2858,3103,5961,0,40
"11UBJA","Weedon",1578,780,798,1577,0,34
"11UBJB","Wendover",8511,4285,4226,7446,1065,143
"11UBJC","Wing",2897,1429,1468,2859,38,66
"11UBJD","Wingrave",2690,1345,1345,2656,34,52
"11UBJE","Winslow",5868,2799,3069,5797,71,131
"11UCGH","Amersham Common",2416,1211,1205,2416,0,70
"11UCGJ","Amersham-on-the-Hill",4506,2119,2387,4450,56,83
"11UCGK","Amersham Town",4392,2131,2261,4369,23,86
"11UCGL","Asheridge Vale and Lowndes",4495,2171,2324,4451,44,58
"11UCGM","Ashley Green, Latimer and Chenies",2183,1058,1125,2183,0,57
"11UCGN","Austenwood",2197,1045,1152,2116,81,89
"11UCGP","Ballinger, South Heath and Chartridge",2204,1077,1127,2204,0,67
"11UCGQ","Central",4086,1897,2189,3962,124,78
"11UCGR","Chalfont Common",4545,2221,2324,3761,784,95
"11UCGS","Chalfont St Giles",6696,3215,3481,6670,26,211
"11UCGT","Chesham Bois and Weedon Hill",4921,2406,2515,4853,68,186
"11UCGU","Cholesbury, The Lee and Bellingdon",2290,1135,1155,2290,0,61
"11UCGW","Gold Hill",2109,989,1120,2040,69,26
"11UCGX","Great Missenden",2192,1017,1175,2121,71,62
"11UCGY","Hilltop and Townsend",4404,2184,2220,4369,35,53
"11UCGZ","Holmer Green",4077,2001,2076,4039,38,73
"11UCHA","Little Chalfont",4497,2120,2377,4489,8,96
"11UCHB","Little Missenden",2433,1164,1269,2393,40,84
"11UCHC","Newtown",2310,1142,1168,2310,0,29
"11UCHD","Penn and Coleshill",4357,2108,2249,4319,38,188
"11UCHE","Prestwood and Heath End",6537,3196,3341,6537,0,169
"11UCHF","Ridgeway",2527,1227,1300,2527,0,18
"11UCHG","St Mary's and Waterside",4510,2137,2373,4447,63,40
"11UCHH","Seer Green",2267,1117,1150,2231,36,67
"11UCHJ","Vale",2077,1040,1037,2077,0,17
"11UEFX","Beaconsfield North",4546,2113,2433,4525,21,175
"11UEFY","Beaconsfield South",3132,1492,1640,2996,136,54
"11UEFZ","Beaconsfield West",3001,1490,1511,3001,0,64
"11UEGA","Burnham Beeches",1252,639,613,1214,38,46
"11UEGB","Burnham Church",4921,2327,2594,4913,8,68
"11UEGC","Burnham Lent Rise",4509,2174,2335,4461,48,33
"11UEGD","Denham North",2640,1224,1416,2518,122,21
"11UEGE","Denham South",3341,1635,1706,3314,27,36
"11UEGF","Dorney and Burnham South",1543,748,795,1506,37,34
"11UEGG","Farnham Royal",5002,2428,2574,4832,170,148
"11UEGH","Gerrards Cross East and Denham South West",1768,872,896,1768,0,24
"11UEGJ","Gerrards Cross North",2923,1380,1543,2772,151,108
"11UEGK","Gerrards Cross South",3218,1579,1639,3103,115,114
"11UEGL","Hedgerley and Fulmer",1385,686,699,1376,9,34
"11UEGM","Iver Heath",4567,2247,2320,4549,18,35
"11UEGN","Iver Village and Richings Park",4675,2327,2348,4644,31,45
"11UEGP","Stoke Poges",4839,2339,2500,4798,41,93
"11UEGQ","Taplow",1584,802,782,1530,54,38
"11UEGR","Wexham and Iver West",3099,1501,1598,3007,92,37
"11UFGK","Abbey",9178,4349,4829,7978,1200,126
"11UFGL","Bledlow and Bradenham",2971,1543,1428,2586,385,95
"11UFGM","Booker and Cressex",4756,2285,2471,4562,194,32
"11UFGN","Bourne End-cum-Hedsor",5404,2584,2820,5382,22,104
"11UFGP","Bowerdean",5529,2774,2755,5529,0,63
"11UFGQ","Chiltern Rise",5390,2637,2753,5384,6,65
"11UFGR","Disraeli",5592,2734,2858,5589,3,48
"11UFGS","Downley and Plomer Hill",4851,2433,2418,4851,0,78
"11UFGT","Flackwell Heath and Little Marlow",7205,3496,3709,7198,7,126
"11UFGU","Greater Hughenden",8506,4175,4331,8476,30,201
"11UFGW","Greater Marlow",5192,2607,2585,5192,0,179
"11UFGX","Hambleden Valley",2617,1292,1325,2557,60,93
"11UFGY","Hazlemere North",4813,2403,2410,4805,8,83
"11UFGZ","Hazlemere South",4537,2194,2343,4537,0,106
"11UFHA","Icknield",3038,1494,1544,3025,13,74
"11UFHB","Lacey Green, Speen and the Hampdens",2672,1318,1354,2672,0,111
"11UFHC","Marlow North and West",8607,4126,4481,8568,39,162
"11UFHD","Marlow South East",5397,2623,2774,5386,11,90
"11UFHE","Micklefield",5530,2745,2785,5518,12,36
"11UFHF","Oakridge and Castlefield",8693,4331,4362,8647,46,55
"11UFHG","Ryemead",4984,2443,2541,4980,4,53
"11UFHH","Sands",5654,2877,2777,5632,22,32
"11UFHJ","Stokenchurch and Radnage",5459,2672,2787,5459,0,89
"11UFHK","Terriers and Amersham Hill",8747,4201,4546,8584,163,152
"11UFHL","Totteridge",5371,2615,2756,5365,6,47
"11UFHM","The Risboroughs",7978,3783,4195,7875,103,128
"11UFHN","The Wooburns",4853,2341,2512,4824,29,52
"11UFHP","Tylers Green and Loudwater",8581,4224,4357,8511,70,150
"12UBFQ","Abbey",8396,4234,4162,8395,3,41
"12UBFR","Arbury",8806,4482,4324,8469,337,99
"12UBFS","Castle",7244,3778,3466,4628,2616,89
"12UBFT","Cherry Hinton",8303,4026,4277,8279,24,94
"12UBFU","Coleridge",7427,3556,3871,7311,116,83
"12UBFW","East Chesterton",7470,3632,3838,7374,96,71
"12UBFX","King's Hedges",8304,4101,4203,8162,142,53
"12UBFY","Market",7512,4192,3320,3503,4009,48
"12UBFZ","Newnham",7819,3920,3899,3874,3945,106
"12UBGA","Petersfield",6948,3520,3428,6225,723,121
"12UBGB","Queen Edith's",8078,3676,4402,7172,906,187
"12UBGC","Romsey",7981,3970,4011,7932,49,52
"12UBGD","Trumpington",6554,3189,3365,5842,712,109
"12UBGE","West Chesterton",8021,4040,3981,7886,135,182
"12UCFU","Bottisham",3799,1858,1941,3676,123,74
"12UCFW","Burwell",5833,2875,2958,5805,28,72
"12UCFX","Cheveley",3901,1905,1996,3890,11,86
"12UCFY","Downham Villages",4185,2094,2091,4132,53,45
"12UCFZ","Dullingham Villages",2167,1074,1093,2167,0,32
"12UCGA","Ely East",3787,1844,1943,3446,341,39
"12UCGB","Ely North",5236,2556,2680,5170,66,49
"12UCGC","Ely South",2360,1188,1172,2339,21,28
"12UCGD","Ely West",3719,1796,1923,3675,44,44
"12UCGE","Fordham Villages",3736,1829,1907,3712,24,36
"12UCGF","Haddenham",5731,2847,2884,5731,0,65
"12UCGG","Isleham",2347,1163,1184,2347,0,19
"12UCGH","Littleport East",4844,2374,2470,4728,116,19
"12UCGJ","Littleport West",2677,1309,1368,2642,35,18
"12UCGK","Soham North",3737,1892,1845,3737,0,26
"12UCGL","Soham South",6200,3106,3094,6133,67,42
"12UCGM","Stretham",3609,1826,1783,3597,12,46
"12UCGN","Sutton",3363,1668,1695,3363,0,38
"12UCGP","The Swaffhams",1983,982,1001,1981,0,48
"12UDGC","Bassenhally",1600,789,811,1600,0,11
"12UDGD","Benwick, Coates and Eastrea",3999,1991,2008,3957,42,41
"12UDGE","Birch",1983,962,1021,1983,0,5
"12UDGF","Clarkson",2129,1022,1107,2081,48,27
"12UDGG","Delph",1873,900,973,1867,6,14
"12UDGH","Doddington",2088,1040,1048,2041,47,18
"12UDGJ","Elm and Christchurch",4014,1973,2041,3934,80,24
"12UDGK","Hill",4265,1963,2302,4178,87,22
"12UDGL","Kingsmoor",1735,848,887,1735,0,14
"12UDGM","Kirkgate",2209,1086,1123,2172,37,13
"12UDGN","Lattersey",2437,1167,1270,2409,28,29
"12UDGP","Manea",1579,774,805,1569,10,5
"12UDGQ","March East",6616,3166,3450,6602,14,41
"12UDGR","March North",6377,3265,3112,6013,364,38
"12UDGS","March West",6049,2874,3175,5918,131,43
"12UDGT","Medworth",2116,1004,1112,2076,40,21
"12UDGU","Parson Drove and Wisbech St Mary",4049,1992,2057,4049,0,33
"12UDGW","Peckover",2144,1037,1107,2126,18,26
"12UDGX","Roman Bank",5630,2785,2845,5608,22,49
"12UDGY","St Andrews",2422,1191,1231,2422,0,25
"12UDGZ","St Marys",2375,1109,1266,2271,104,19
"12UDHA","Slade Lode",2248,1127,1121,2209,39,3
"12UDHB","Staithe",2456,1195,1261,2447,9,14
"12UDHC","The Mills",2458,1213,1245,2458,0,5
"12UDHD","Waterlees",4881,2351,2530,4822,59,9
"12UDHE","Wenneye",2131,1056,1075,2107,24,14
"12UDHF","Wimblington",1656,818,838,1639,17,15
"12UEGM","Alconbury and The Stukeleys",4014,2030,1984,3858,156,57
"12UEGN","Brampton",6761,3546,3215,6201,560,128
"12UEGP","Buckden",3009,1437,1572,2974,35,52
"12UEGQ","Earith",6192,3115,3077,6169,23,106
"12UEGR","Ellington",3170,1572,1598,3133,37,59
"12UEGS","Elton and Folksworth",2713,1340,1373,2701,12,67
"12UEGT","Fenstanton",2868,1400,1468,2868,0,49
"12UEGU","Godmanchester",5996,2954,3042,5985,11,85
"12UEGW","Gransden and The Offords",4534,2267,2267,4480,54,84
"12UEGX","Huntingdon East",8770,4321,4449,8708,62,95
"12UEGY","Huntingdon North",5793,2826,2967,5777,16,14
"12UEGZ","Huntingdon West",6037,2966,3071,5915,122,64
"12UEHA","Kimbolton and Staughton",3202,1625,1577,3133,69,59
"12UEHB","Little Paxton",3006,1535,1471,2964,42,48
"12UEHC","Ramsey",8047,4044,4003,8026,21,98
"12UEHD","St Ives East",7075,3554,3521,7075,0,95
"12UEHE","St Ives South",6140,2972,3168,6109,31,89
"12UEHF","St Ives West",2786,1394,1392,2786,0,71
"12UEHG","St Neots Eaton Ford",6888,3447,3441,6845,43,135
"12UEHH","St Neots Eaton Socon",5547,2713,2834,5514,33,34
"12UEHJ","St Neots Eynesbury",8974,4502,4472,8917,57,46
"12UEHK","St Neots Priory Park",5963,2859,3104,5926,37,50
"12UEHL","Sawtry",6843,3386,3457,6810,33,89
"12UEHM","Somersham",5770,2865,2905,5735,35,93
"12UEHN","Stilton",3110,1548,1562,3094,16,47
"12UEHP","The Hemingfords",5684,2769,2915,5684,0,132
"12UEHQ","Upwood and The Raveleys",2896,1484,1412,2821,75,79
"12UEHR","Warboys and Bury",6106,3032,3074,6062,44,83
"12UEHS","Yaxley and Farcet",9060,4488,4572,9016,44,84
"12UGGW","Balsham",4465,2224,2241,4442,23,126
"12UGGX","Bar Hill",5177,2596,2581,5175,0,95
"12UGGY","Barton",2330,1109,1221,2330,0,65
"12UGGZ","Bassingbourn",5403,2999,2404,4641,762,78
"12UGHA","Bourn",2828,1379,1449,2825,3,55
"12UGHB","Caldecote",1615,794,821,1568,47,41
"12UGHC","Comberton",2189,1073,1116,2189,0,54
"12UGHD","Cottenham",7389,3540,3849,7241,148,117
"12UGHE","Duxford",2491,1230,1261,2491,0,54
"12UGHF","Fowlmere and Foxton",2351,1183,1168,2351,0,41
"12UGHG","Fulbourn",4704,2289,2415,4530,174,75
"12UGHH","Gamlingay",4805,2458,2347,4795,10,59
"12UGHJ","Girton",3752,1809,1943,3359,393,79
"12UGHK","Hardwick",2630,1321,1309,2630,0,61
"12UGHL","Harston and Hauxton",2379,1153,1226,2374,5,56
"12UGHM","Haslingfield and The Eversdens",2639,1301,1338,2632,7,78
"12UGHN","Histon and Impington",8387,4063,4324,8324,63,124
"12UGHP","Linton",4614,2223,2391,4560,54,73
"12UGHQ","Longstanton",1700,865,835,1686,14,20
"12UGHR","Melbourn",5228,2533,2695,5173,55,90
"12UGHS","Meldreth",2460,1211,1249,2335,125,28
"12UGHT","Milton",4275,2163,2112,4248,27,69
"12UGHU","Orwell and Barrington",2211,1077,1134,2211,0,56
"12UGHW","Papworth and Elsworth",3988,1975,2013,3815,173,61
"12UGHX","Sawston",7150,3574,3576,7088,62,116
"12UGHY","Swavesey",2480,1242,1238,2480,0,43
"12UGHZ","Teversham",2665,1306,1359,2657,8,25
"12UGJA","The Abingtons",2310,1156,1154,2310,0,44
"12UGJB","The Mordens",2216,1101,1115,2215,3,53
"12UGJC","The Shelfords and Stapleford",6885,3333,3552,6859,26,185
"12UGJD","The Wilbrahams",2537,1262,1275,2535,3,41
"12UGJE","Waterbeach",5256,2604,2652,5137,119,106
"12UGJF","Whittlesford",2420,1224,1196,2420,0,53
"12UGJG","Willingham and Over",6179,3084,3095,6179,0,88
"13UBGE","Barrow",1923,942,981,1871,52,38
"13UBGF","Blacon Hall",7977,3788,4189,7943,34,39
"13UBGG","Blacon Lodge",5518,2668,2850,5477,41,28
"13UBGH","Boughton",3741,1812,1929,3685,56,22
"13UBGJ","Boughton Heath",3878,1836,2042,3878,0,47
"13UBGK","Christleton",4281,2054,2227,4201,80,119
"13UBGL","City & St Anne's",2892,1403,1489,2848,44,14
"13UBGM","College",5434,2349,3085,4896,538,30
"13UBGN","Curzon & Westminster",4162,2019,2143,4096,66,134
"13UBGP","Dodleston",1975,983,992,1975,0,41
"13UBGQ","Elton",4279,2125,2154,4235,44,37
"13UBGR","Farndon",1852,914,938,1852,0,45
"13UBGS","Handbridge & St Mary's",4223,1992,2231,4212,11,76
"13UBGT","Hoole All Saints",3344,1653,1691,3189,155,19
"13UBGU","Hoole Groves",4112,2020,2092,4062,50,39
"13UBGW","Huntington",1961,965,996,1961,0,27
"13UBGX","Kelsall",3439,1673,1766,3407,32,83
"13UBGY","Lache Park",6299,2983,3316,6299,0,55
"13UBGZ","Malpas",3887,1896,1991,3838,49,86
"13UBHA","Mickle Trafford",2252,1116,1136,2250,0,46
"13UBHB","Mollington",2077,1048,1029,1914,163,42
"13UBHC","Newton Brook",3897,1947,1950,3864,33,44
"13UBHD","Newton St Michaels",3541,1626,1915,3507,34,32
"13UBHE","Saughall",3585,1740,1845,3550,35,54
"13UBHF","Tarvin",4175,2025,2150,4110,65,82
"13UBHG","Tattenhall",3601,1788,1813,3597,4,78
"13UBHH","Tilston",2001,972,1029,1995,6,53
"13UBHJ","Upton Grange",6322,3030,3292,6067,255,90
"13UBHK","Upton Westlea",3857,1844,2013,3849,8,66
"13UBHL","Vicars Cross",5663,2731,2932,5663,0,66
"13UBHM","Waverton",2062,1009,1053,2061,0,53
"13UCFU","Alsager Central",3677,1776,1901,3227,450,99
"13UCFW","Alsager East",5180,2509,2671,5148,32,71
"13UCFX","Alsager West",3721,1772,1949,3721,0,75
"13UCFY","Astbury",1774,895,879,1774,0,39
"13UCFZ","Brereton",1752,892,860,1743,9,34
"13UCGA","Buglawton",2987,1475,1512,2976,11,44
"13UCGB","Congleton Central",4355,2096,2259,4311,44,47
"13UCGC","Congleton North",3727,1823,1904,3656,71,24
"13UCGD","Congleton North West",3565,1777,1788,3489,76,46
"13UCGE","Congleton South",5867,2885,2982,5795,72,140
"13UCGF","Congleton West",5249,2573,2676,5180,69,81
"13UCGG","Dane Valley",3747,1880,1867,3742,5,79
"13UCGH","Holmes Chapel",5669,2788,2881,5650,19,130
"13UCGJ","Lawton",3102,1459,1643,3041,61,31
"13UCGK","Middlewich Cledford",6846,3452,3394,6841,5,51
"13UCGL","Middlewich Kinderton",6255,3048,3207,6190,65,66
"13UCGM","Odd Rode",5552,2762,2790,5531,21,62
"13UCGN","Sandbach East",5491,2669,2822,5461,30,62
"13UCGP","Sandbach North",5795,2818,2977,5728,67,113
"13UCGQ","Sandbach West",6344,3135,3209,6286,58,59
"13UDGD","Acton",2024,968,1056,1984,40,32
"13UDGE","Alexandra",5913,2940,2973,5786,127,27
"13UDGF","Audlem",3603,1780,1823,3542,61,75
"13UDGG","Barony Weaver",5298,2503,2795,5279,19,30
"13UDGH","Birchin",3909,1874,2035,3768,141,54
"13UDGJ","Bunbury",2131,1047,1084,2131,0,57
"13UDGK","Coppenhall",4346,2077,2269,4312,34,21
"13UDGL","Delamere",4101,2001,2100,4032,69,6
"13UDGM","Englesea",1928,952,976,1928,0,19
"13UDGN","Grosvenor",3553,1738,1815,3550,3,8
"13UDGP","Haslington",6430,3144,3286,6355,75,68
"13UDGQ","Leighton",6415,3272,3143,6385,30,28
"13UDGR","Maw Green",5756,2749,3007,5653,103,13
"13UDGS","Minshull",2001,985,1016,1676,325,17
"13UDGT","Peckforton",1941,975,966,1941,0,32
"13UDGU","St Barnabas",6192,3047,3145,6127,65,22
"13UDGW","St John's",5451,2723,2728,5447,4,34
"13UDGX","St Mary's",3869,1876,1993,3843,26,65
"13UDGY","Shavington",4051,1990,2061,4043,8,37
"13UDGZ","Valley",3860,1891,1969,3802,58,21
"13UDHA","Waldron",5853,2798,3055,5586,267,28
"13UDHB","Wellington",3308,1583,1725,3224,84,52
"13UDHC","Wells Green",3985,1997,1988,3985,0,92
"13UDHD","Willaston",2277,1098,1179,2275,0,30
"13UDHE","Wistaston Green",6510,3179,3331,6492,18,40
"13UDHF","Wrenbury",1796,913,883,1777,19,41
"13UDHG","Wybunbury",4506,2275,2231,4504,3,58
"13UEFU","Burton & Ness",1620,784,836,1620,0,46
"13UEFW","Central",3790,1832,1958,3790,0,8
"13UEFX","Grange",5920,2770,3150,5802,118,12
"13UEFY","Groves",3545,1777,1768,3503,42,38
"13UEFZ","Ledsham",5788,2884,2904,5781,7,59
"13UEGA","Little Neston",3390,1618,1772,3390,0,53
"13UEGB","Neston",3521,1682,1839,3495,26,31
"13UEGC","Parkgate",3702,1739,1963,3559,143,87
"13UEGD","Pooltown",4023,1948,2075,3983,40,12
"13UEGE","Rivacre",4109,1901,2208,4067,42,18
"13UEGF","Riverside",3644,1778,1866,3644,0,53
"13UEGG","Rossmore",5973,2921,3052,5936,37,43
"13UEGH","Stanlow & Wolverham",5475,2641,2834,5445,30,20
"13UEGJ","Strawberry Fields",3715,1903,1812,3715,0,32
"13UEGK","Sutton",5824,2932,2892,5824,0,65
"13UEGL","Sutton Green & Manor",4068,2078,1990,4068,0,30
"13UEGM","Westminster",3465,1665,1800,3430,35,0
"13UEGN","Whitby",6187,3086,3101,6130,57,52
"13UEGP","Willaston & Thornton",3913,1888,2025,3790,123,84
"13UGGN","Alderley Edge",4808,2295,2513,4738,70,117
"13UGGP","Bollington Central",2535,1240,1295,2535,0,41
"13UGGQ","Bollington East",2232,1089,1143,2189,43,32
"13UGGR","Bollington West",2328,1117,1211,2288,40,35
"13UGGS","Chelford",2597,1269,1328,2498,99,72
"13UGGT","Dean Row",5108,2476,2632,5047,61,80
"13UGGU","Disley & Lyme Handley",4452,2147,2305,4363,89,91
"13UGGW","Fulshaw",4828,2335,2493,4828,0,108
"13UGGX","Gawsworth",2257,1112,1145,2257,0,52
"13UGGY","Handforth",8014,3859,4155,7994,20,66
"13UGGZ","Henbury",2308,1139,1169,2302,6,57
"13UGHA","High Legh",2454,1235,1219,2453,0,50
"13UGHB","Hough",4667,2190,2477,4605,62,122
"13UGHC","Knutsford Bexton",2606,1266,1340,2573,33,67
"13UGHD","Knutsford Nether",2356,1053,1303,2345,11,40
"13UGHE","Knutsford Norbury Booths",2589,1251,1338,2589,0,101
"13UGHF","Knutsford Over",5105,2471,2634,5056,49,38
"13UGHG","Lacey Green",2695,1281,1414,2695,0,23
"13UGHH","Macclesfield Bollinbrook",5556,2679,2877,5297,259,91
"13UGHJ","Macclesfield Broken Cross",5685,2730,2955,5610,75,78
"13UGHK","Macclesfield Central",5340,2556,2784,5294,46,31
"13UGHL","Macclesfield East",5173,2584,2589,5173,0,65
"13UGHM","Macclesfield Hurdsfield",4022,1985,2037,4022,0,16
"13UGHN","Macclesfield Ivy",5234,2577,2657,5200,34,107
"13UGHP","Macclesfield Ryles",2671,1275,1396,2593,78,33
"13UGHQ","Macclesfield South",5558,2664,2894,5439,119,24
"13UGHR","Macclesfield Tytherington",5787,2846,2941,5784,3,129
"13UGHS","Macclesfield West",5093,2367,2726,5057,36,30
"13UGHT","Mere",2062,997,1065,1964,98,47
"13UGHU","Mobberley",2546,1232,1314,2446,100,48
"13UGHW","Morley & Styal",5014,2292,2722,4619,395,89
"13UGHX","Plumley",2262,1165,1097,2036,226,41
"13UGHY","Poynton Central",6792,3270,3522,6721,71,153
"13UGHZ","Poynton East",2322,1146,1176,2247,75,64
"13UGJA","Poynton West",5319,2597,2722,5319,0,140
"13UGJB","Prestbury",5034,2404,2630,4914,120,151
"13UGJC","Rainow",2505,1246,1259,2493,12,50
"13UGJD","Sutton",2241,1080,1161,2169,72,57
"13UHGP","Barnton",5527,2700,2827,5514,13,48
"13UHGQ","Cogshall",2159,1065,1094,2159,0,41
"13UHGR","Cuddington & Oakmere",5766,2834,2932,5662,104,145
"13UHGS","Davenham & Moulton",5667,2795,2872,5635,32,72
"13UHGT","Forest",2219,1107,1112,2170,49,54
"13UHGU","Frodsham North",6840,3321,3519,6774,66,99
"13UHGW","Frodsham South",2142,1060,1082,2111,31,45
"13UHGX","Hartford & Whitegate",6486,3220,3266,6349,137,149
"13UHGY","Helsby",4701,2240,2461,4622,79,74
"13UHGZ","Kingsley",2026,989,1037,1996,30,55
"13UHHA","Leftwich & Kingsmead",6796,3370,3426,6790,6,64
"13UHHB","Lostock & Wincham",4222,2114,2108,4108,114,68
"13UHHC","Mara",1679,836,843,1679,0,41
"13UHHD","Milton Weaver",2002,992,1010,2002,0,46
"13UHHE","Northwich Castle",5980,2952,3028,5971,9,63
"13UHHF","Northwich Winnington",2139,1075,1064,2139,0,8
"13UHHG","Northwich Witton",6404,3137,3267,6296,108,31
"13UHHH","Rudheath & South Witton",4692,2319,2373,4690,3,25
"13UHHJ","Seven Oaks & Marston",2238,1119,1119,2238,0,37
"13UHHK","Shakerley",2216,1095,1121,2174,42,41
"13UHHL","Tarporley & Oulton",3916,1905,2011,3906,10,97
"13UHHM","Weaverham",6589,3168,3421,6557,32,69
"13UHHN","Winsford Dene",4300,2063,2237,4158,142,24
"13UHHP","Winsford Gravel",4103,2002,2101,3988,115,24
"13UHHQ","Winsford Over",5495,2653,2842,5488,7,36
"13UHHR","Winsford Swanlow",4630,2297,2333,4608,22,57
"13UHHS","Winsford Verdin",6483,3198,3285,6483,0,39
"13UHHT","Winsford Wharton",4672,2232,2440,4669,3,14
"15UBGH","Callington",4783,2299,2484,4675,108,40
"15UBGJ","Calstock",6095,2962,3133,6069,26,74
"15UBGK","Deviock and Sheviock",2024,990,1034,1968,56,30
"15UBGL","Dobwalls and District",3662,1762,1900,3645,17,54
"15UBGM","Duloe, Lansallos and Pelynt",3882,1871,2011,3796,86,43
"15UBGN","Landrake and St Dominick",3914,1943,1971,3907,7,58
"15UBGP","Lanteglos and St Veep",1842,897,945,1842,0,34
"15UBGQ","Liskeard North",4726,2230,2496,4646,80,28
"15UBGR","Liskeard South",3930,1849,2081,3878,52,45
"15UBGS","Looe and St Martin",5601,2679,2922,5486,115,44
"15UBGT","Lynher",1945,957,988,1931,14,22
"15UBGU","Menheniot and St Ive",3726,1830,1896,3721,5,36
"15UBGW","Millbrook",2033,988,1045,2027,6,34
"15UBGX","Rame Peninsula",1882,943,939,1857,25,23
"15UBGY","St Cleer and St Neot",4327,2109,2218,4315,12,52
"15UBGZ","St Germans",1856,916,940,1854,3,30
"15UBHA","Saltash Burraton",3764,1795,1969,3743,21,53
"15UBHB","Saltash Essa",4044,1922,2122,3980,64,50
"15UBHC","Saltash Pill",3074,1464,1610,3011,63,39
"15UBHD","Saltash St Stephens",4082,1984,2098,4054,28,56
"15UBHE","Torpoint East",3867,1803,2064,3737,130,28
"15UBHF","Torpoint West",4590,2383,2207,4189,401,44
"15UCFX","Arwenack",6154,2899,3255,5835,319,82
"15UCFY","Boscawen",5516,2505,3011,5333,183,76
"15UCFZ","Boslowick",5387,2578,2809,5387,0,51
"15UCGA","Carland",1903,928,975,1873,30,23
"15UCGB","Feock and Kea",5195,2438,2757,5185,10,112
"15UCGC","Kenwyn and Chacewater",5555,2717,2838,5555,0,96
"15UCGD","Moresk",3346,1525,1821,3284,62,68
"15UCGE","Mount Hawke",3548,1712,1836,3516,32,29
"15UCGF","Mylor",5592,2665,2927,5592,0,94
"15UCGG","Newlyn and Goonhavern",3813,1869,1944,3722,91,47
"15UCGH","Penryn",6227,2986,3241,6221,6,41
"15UCGJ","Penwerris",5617,2708,2909,5427,190,39
"15UCGK","Perranporth",4003,1943,2060,3930,73,67
"15UCGL","Probus",5861,2876,2985,5832,29,85
"15UCGM","Roseland",3521,1717,1804,3471,50,56
"15UCGN","St Agnes",3709,1752,1957,3639,70,51
"15UCGP","Tregolls",3530,1699,1831,3432,98,56
"15UCGQ","Trehaverne and Gloweth",5771,2697,3074,5513,258,83
"15UCGR","Trescobeas",3617,1695,1922,3570,47,43
"15UDFZ","Breage and Crowan",5838,2861,2977,5779,59,79
"15UDGA","Camborne North",6661,3340,3321,6512,149,54
"15UDGB","Camborne South",6875,3334,3541,6827,48,59
"15UDGC","Camborne West",6796,3210,3586,6674,122,53
"15UDGD","Constantine, Gweek and Mawnan",3740,1810,1930,3707,33,63
"15UDGE","Grade-Ruan and Landewednack",1956,983,973,1938,18,27
"15UDGF","Helston North",5910,2884,3026,5842,68,76
"15UDGG","Helston South",4323,2047,2276,4282,41,42
"15UDGH","Illogan North",6922,3378,3544,6889,33,67
"15UDGJ","Illogan South",7144,3474,3670,7103,41,46
"15UDGK","Mabe and Budock",3946,1915,2031,3900,46,47
"15UDGL","Meneage",2539,1428,1111,2124,415,33
"15UDGM","Mullion",1986,926,1060,1920,66,30
"15UDGN","Porthleven and Sithney",3830,1834,1996,3821,9,34
"15UDGP","Redruth North",6501,3114,3387,6453,48,39
"15UDGQ","Redruth South",5851,2869,2982,5773,78,50
"15UDGR","St Day, Lanner and Carharrack",5438,2599,2839,5404,34,56
"15UDGS","St Keverne",2107,1014,1093,2068,39,20
"15UDGT","Stithians",2004,991,1013,1997,7,30
"15UDGU","Wendron",2150,1070,1080,2147,3,26
"15UEGE","Allan",2271,1123,1148,2263,8,41
"15UEGF","Altarnun",2042,994,1048,2015,27,30
"15UEGG","Blisland and St Breward",2238,1136,1102,2238,0,50
"15UEGH","Bodmin St Mary's",6806,3271,3535,6756,50,38
"15UEGJ","Bodmin St Petroc",6075,2954,3121,5898,177,68
"15UEGK","Bude",4675,2178,2497,4534,141,65
"15UEGL","Camelford",2256,1072,1184,2207,49,27
"15UEGM","Camelot",4364,2111,2253,4315,49,44
"15UEGN","Grenville",1961,999,962,1947,14,45
"15UEGP","Lanivet",2366,1146,1220,2323,43,37
"15UEGQ","Launceston",7135,3388,3747,6949,186,69
"15UEGR","Marhamchurch",2122,1030,1092,2088,34,40
"15UEGS","North Petherwin",2357,1180,1177,2332,25,28
"15UEGT","Padstow and District",7022,3428,3594,6929,93,74
"15UEGU","Poughill and Stratton",4567,2237,2330,4494,73,75
"15UEGW","St Endellion and St Kew",2169,1078,1091,2150,19,36
"15UEGX","St Minver",2474,1178,1296,2378,96,29
"15UEGY","South Petherwin",2220,1088,1132,2110,110,25
"15UEGZ","Stokeclimsland",2421,1198,1223,2370,51,46
"15UEHA","Tremaine",2232,1115,1117,2229,3,34
"15UEHB","Valency",2166,1049,1117,2165,3,37
"15UEHC","Wadebridge",6351,2991,3360,6272,79,65
"15UEHD","Week St Mary and Whitstone",2219,1115,1104,2181,38,40
"15UFFS","Goldsithney",1870,856,1014,1838,32,12
"15UFFT","Gulval and Heamoor",3660,1724,1936,3650,10,34
"15UFFU","Gwinear, Gwithian and Hayle East",3875,1901,1974,3817,58,41
"15UFFW","Hayle North",3726,1812,1914,3703,23,30
"15UFFX","Hayle South",3748,1806,1942,3633,115,25
"15UFFY","Lelant and Carbis Bay",3482,1649,1833,3334,148,37
"15UFFZ","Ludgvan and Towednack",3554,1748,1806,3516,38,49
"15UFGA","Madron and Zennor",1750,839,911,1693,57,33
"15UFGB","Marazion and Perranuthnoe",1825,880,945,1806,19,19
"15UFGC","Morvah, Pendeen and St Just",4769,2297,2472,4720,49,44
"15UFGD","Penzance Central",3677,1728,1949,3640,37,31
"15UFGE","Penzance East",5886,2871,3015,5773,113,47
"15UFGF","Penzance Promenade",3026,1370,1656,2964,62,27
"15UFGG","Penzance South",4919,2329,2590,4895,24,50
"15UFGH","St Buryan",3393,1659,1734,3348,45,61
"15UFGJ","St Erth and St Hilary",2169,1084,1085,2155,14,37
"15UFGK","St Ives North",4134,1944,2190,4118,16,45
"15UFGL","St Ives South",3549,1703,1846,3324,225,43
"15UGFU","Bethel",5841,2877,2964,5835,6,61
"15UGFW","Crinnis",1821,855,966,1813,8,35
"15UGFX","Edgcumbe North",4408,2171,2237,4262,146,51
"15UGFY","Edgcumbe South",4871,2368,2503,4845,26,34
"15UGFZ","Fowey and Tywardreath",5657,2674,2983,5564,93,91
"15UGGA","Gannel",6010,2870,3140,5721,289,65
"15UGGB","Gover",4249,2021,2228,4139,110,65
"15UGGC","Lostwithiel",4602,2247,2355,4490,112,45
"15UGGD","Mevagissey",3785,1858,1927,3736,49,38
"15UGGE","Mount Charles",5817,2767,3050,5621,196,48
"15UGGF","Poltair",4104,1965,2139,4083,21,29
"15UGGG","Rialton",6664,3273,3391,6354,310,71
"15UGGH","Rock",6371,3177,3194,6346,25,33
"15UGGJ","St Blaise",6632,3250,3382,6582,50,40
"15UGGK","St Columb",4570,2193,2377,4500,70,54
"15UGGL","St Enoder",4409,2230,2179,4391,18,22
"15UGGM","St Ewe",3877,1868,2009,3833,44,57
"15UGGN","St Stephen",7348,3649,3699,7324,24,38
"15UGGP","Treverbyn",4526,2277,2249,4518,8,28
"15UHFB","St. Agnes",165,90,75,151,14,15
"15UHFC","St. Martin's",142,72,70,122,20,0
"15UHFD","St. Mary's",1666,820,846,1597,69,52
"15UHFE","Tresco",180,90,90,147,33,7
"16UBGM","All Saints",4767,2343,2424,4765,3,92
"16UBGN","Aspatria",3266,1573,1693,3254,12,24
"16UBGP","Boltons",1747,892,855,1687,60,35
"16UBGQ","Broughton St Bridget's",3834,1907,1927,3827,7,66
"16UBGR","Christchurch",3110,1455,1655,3012,98,81
"16UBGS","Clifton",1492,719,773,1464,28,8
"16UBGT","Crummock",1477,722,755,1451,26,52
"16UBGU","Dalton",1585,786,799,1585,0,46
"16UBGW","Derwent Valley",1645,822,823,1476,169,36
"16UBGX","Ellen",3082,1533,1549,3070,12,30
"16UBGY","Ellenborough",3683,1760,1923,3651,32,19
"16UBGZ","Ewanrigg",3496,1648,1848,3484,12,11
"16UBHA","Flimby",1636,800,836,1630,6,4
"16UBHB","Harrington",2967,1492,1475,2936,31,43
"16UBHC","Holme",1659,819,840,1659,0,13
"16UBHD","Keswick",5391,2585,2806,4993,398,68
"16UBHE","Marsh",1692,850,842,1692,0,32
"16UBHF","Moorclose",4864,2296,2568,4864,0,26
"16UBHG","Moss Bay",4438,2106,2332,4402,36,13
"16UBHH","Netherhall",3186,1555,1631,3073,113,13
"16UBHJ","St John's",5361,2658,2703,5246,115,53
"16UBHK","St Michael's",5221,2650,2571,5221,0,16
"16UBHL","Seaton",5033,2438,2595,5028,5,45
"16UBHM","Silloth",3305,1575,1730,3219,86,25
"16UBHN","Solway",1632,804,828,1626,6,28
"16UBHP","Stainburn",1630,803,827,1571,59,22
"16UBHQ","Wampool",1665,829,836,1665,0,34
"16UBHR","Warnell",1889,942,947,1856,33,34
"16UBHS","Waver",1834,916,918,1834,0,32
"16UBHT","Wharrels",1545,767,778,1535,10,30
"16UBHU","Wigton",5360,2522,2838,5281,79,46
"16UCFP","Barrow Island",2606,1326,1280,2606,0,7
"16UCFQ","Central",5585,2744,2841,5481,104,15
"16UCFR","Dalton North",6599,3279,3320,6571,28,54
"16UCFS","Dalton South",6200,3010,3190,6160,40,65
"16UCFT","Hawcoat",5308,2532,2776,5116,192,87
"16UCFU","Hindpool",5515,2675,2840,5503,12,24
"16UCFW","Newbarns",5912,2887,3025,5852,60,61
"16UCFX","Ormsgill",5961,2883,3078,5961,0,37
"16UCFY","Parkside",5742,2781,2961,5665,77,61
"16UCFZ","Risedale",5663,2732,2931,5632,31,13
"16UCGA","Roosecote",5501,2694,2807,5501,0,62
"16UCGB","Walney North",5604,2695,2909,5525,79,36
"16UCGC","Walney South",5784,2854,2930,5784,0,33
"16UDGA","Belah",5986,2881,3105,5975,11,75
"16UDGB","Belle Vue",5625,2715,2910,5523,102,23
"16UDGC","Botcherby",5866,2739,3127,5786,80,27
"16UDGD","Brampton",4361,2074,2287,4267,94,55
"16UDGE","Burgh",1973,1006,967,1973,0,38
"16UDGF","Castle",5452,2791,2661,5179,273,36
"16UDGG","Currock",5927,2876,3051,5904,23,29
"16UDGH","Dalston",5172,2544,2628,4928,244,73
"16UDGJ","Denton Holme",5943,2819,3124,5860,83,34
"16UDGK","Great Corby and Geltsdale",2028,1004,1024,2028,0,38
"16UDGL","Harraby",5685,2749,2936,5648,37,23
"16UDGM","Hayton",2031,1009,1022,2031,0,47
"16UDGN","Irthing",1979,997,982,1967,12,41
"16UDGP","Longtown & Rockcliffe",3973,1960,2013,3902,71,34
"16UDGQ","Lyne",1937,995,942,1937,0,20
"16UDGR","Morton",5942,2742,3200,5903,39,16
"16UDGS","St Aidans",5670,2752,2918,5640,30,31
"16UDGT","Stanwix Rural",3976,1940,2036,3935,41,52
"16UDGU","Stanwix Urban",5724,2699,3025,5571,153,97
"16UDGW","Upperby",5487,2606,2881,5440,47,20
"16UDGX","Wetheral",4039,1954,2085,3977,62,97
"16UDGY","Yewdale",5963,2883,3080,5939,24,40
"16UEGD","Arlecdon",1539,788,751,1537,0,24
"16UEGE","Beckermet",2740,1385,1355,2737,3,42
"16UEGF","Bootle",1354,660,694,1335,19,14
"16UEGG","Bransty",4657,2313,2344,4611,46,47
"16UEGH","Cleator Moor North",4160,2040,2120,4160,0,22
"16UEGJ","Cleator Moor South",2779,1344,1435,2735,44,16
"16UEGK","Distington",3944,1910,2034,3899,45,28
"16UEGL","Egremont North",4078,2002,2076,4073,5,32
"16UEGM","Egremont South",3707,1846,1861,3674,33,33
"16UEGN","Ennerdale",1003,508,495,1003,0,12
"16UEGP","Frizington",2581,1322,1259,2575,6,31
"16UEGQ","Gosforth",1401,695,706,1355,46,31
"16UEGR","Harbour",3949,2009,1940,3891,58,30
"16UEGS","Haverigg",1791,1161,630,1264,527,15
"16UEGT","Hensingham",4212,2021,2191,4162,50,29
"16UEGU","Hillcrest",2638,1368,1270,2631,7,42
"16UEGW","Holborn Hill",2562,1236,1326,2562,0,26
"16UEGX","Kells",2429,1186,1243,2429,0,9
"16UEGY","Millom Without",1430,719,711,1403,27,40
"16UEGZ","Mirehouse",4632,2204,2428,4542,90,12
"16UEHA","Moresby",1280,628,652,1236,44,14
"16UEHB","Newtown",3541,1743,1798,3497,44,30
"16UEHC","St Bees",1508,777,731,1480,28,37
"16UEHD","Sandwith",2569,1278,1291,2569,0,10
"16UEHE","Seascale",2834,1395,1439,2801,33,35
"16UFGF","Alston Moor",2156,1070,1086,2133,23,24
"16UFGG","Appleby (Appleby)",1317,632,685,1290,27,13
"16UFGH","Appleby (Bongate)",1545,751,794,1526,19,20
"16UFGJ","Askham",1326,658,668,1296,30,22
"16UFGK","Brough",1231,623,608,1225,6,10
"16UFGL","Crosby Ravensworth",1339,715,624,1259,80,24
"16UFGM","Dacre",1326,634,692,1326,0,21
"16UFGN","Eamont",1315,645,670,1248,67,16
"16UFGP","Greystoke",1380,687,693,1365,15,33
"16UFGQ","Hartside",1083,555,528,1080,3,18
"16UFGR","Hesket",2834,1437,1397,2699,135,36
"16UFGS","Kirkby Stephen",2495,1200,1295,2438,57,36
"16UFGT","Kirkby Thore",1439,716,723,1432,7,19
"16UFGU","Kirkoswald",1402,706,696,1402,0,26
"16UFGW","Langwathby",1445,701,744,1445,0,20
"16UFGX","Lazonby",1425,692,733,1425,0,27
"16UFGY","Long Marton",1121,542,579,1121,0,18
"16UFGZ","Morland",1190,615,575,1190,0,18
"16UFHA","Orton with Tebay",1322,663,659,1322,0,10
"16UFHB","Penrith Carleton",1450,694,756,1450,0,20
"16UFHC","Penrith East",2618,1223,1395,2573,45,21
"16UFHD","Penrith North",4086,1994,2092,4010,76,60
"16UFHE","Penrith Pategill",1318,582,736,1227,91,7
"16UFHF","Penrith South",2390,1144,1246,2376,14,15
"16UFHG","Penrith West",2894,1407,1487,2874,20,20
"16UFHH","Ravenstonedale",928,454,474,917,11,11
"16UFHJ","Shap",1340,680,660,1340,0,12
"16UFHK","Skelton",1396,742,654,1396,0,28
"16UFHL","Ullswater",1403,691,712,1350,53,33
"16UFHM","Warcop",1263,640,623,1262,0,29
"16UGHB","Arnside & Beetham",4025,1919,2106,3930,95,88
"16UGHC","Broughton",2344,1175,1169,2340,4,56
"16UGHD","Burneside",1988,996,992,1985,3,24
"16UGHE","Burton & Holme",2578,1269,1309,2571,7,40
"16UGHF","Cartmel",1758,826,932,1686,72,22
"16UGHG","Coniston",1867,944,923,1833,34,27
"16UGHH","Crake Valley",1823,924,899,1819,4,30
"16UGHJ","Crooklands",2244,1096,1148,2210,34,33
"16UGHK","Grange",4042,1811,2231,3894,148,55
"16UGHL","Hawkshead",1703,812,891,1634,69,49
"16UGHM","Holker",1808,859,949,1774,34,17
"16UGHN","Kendal Castle",1861,888,973,1821,40,28
"16UGHP","Kendal Far Cross",2080,1006,1074,2080,0,21
"16UGHQ","Kendal Fell",1664,803,861,1619,45,26
"16UGHR","Kendal Glebelands",1877,918,959,1846,31,15
"16UGHS","Kendal Heron Hill",2058,996,1062,2058,0,28
"16UGHT","Kendal Highgate",1762,848,914,1690,72,16
"16UGHU","Kendal Kirkland",1962,942,1020,1922,40,13
"16UGHW","Kendal Mintsfeet",2145,1048,1097,2137,8,27
"16UGHX","Kendal Nether",1762,834,928,1754,8,29
"16UGHY","Kendal Oxenholme",2206,1065,1141,2148,58,17
"16UGHZ","Kendal Parks",2215,1100,1115,2215,0,21
"16UGJA","Kendal Stonecross",1939,902,1037,1900,39,25
"16UGJB","Kendal Strickland",1850,898,952,1844,6,25
"16UGJC","Kendal Underley",2124,1016,1108,2106,18,14
"16UGJD","Kirkby Lonsdale",2534,1143,1391,2110,424,67
"16UGJE","Lakes Ambleside",3560,1636,1924,3184,376,53
"16UGJF","Lakes Grasmere",1567,776,791,1363,204,37
"16UGJG","Levens",1654,783,871,1603,51,39
"16UGJH","Low Furness & Swarthmoor",4023,1957,2066,3929,94,75
"16UGJJ","Lyth Valley",2011,1026,985,1932,79,39
"16UGJK","Milnthorpe",2106,989,1117,2053,53,18
"16UGJL","Natland",1911,948,963,1902,9,45
"16UGJM","Sedbergh",3691,1959,1732,3302,389,79
"16UGJN","Staveley-in-Cartmel",1638,812,826,1587,51,40
"16UGJP","Staveley-in-Westmorland",2044,983,1061,1998,46,40
"16UGJQ","Ulverston Central",2031,982,1049,1866,165,15
"16UGJR","Ulverston East",2032,1004,1028,2028,4,11
"16UGJS","Ulverston North",1903,907,996,1885,18,22
"16UGJT","Ulverston South",1802,870,932,1799,3,22
"16UGJU","Ulverston Town",1865,897,968,1849,16,17
"16UGJW","Ulverston West",1891,927,964,1872,19,41
"16UGJX","Whinfell",2108,1075,1033,2108,0,48
"16UGJY","Windermere Applethwaite",2136,947,1189,1889,247,28
"16UGJZ","Windermere Bowness North",2040,966,1074,1970,70,32
"16UGKA","Windermere Bowness South",1774,900,874,1625,149,21
"16UGKB","Windermere Town",2295,1108,1187,2255,40,20
"17UBGC","Alfreton",7928,3819,4109,7740,188,30
"17UBGD","Alport",2472,1253,1219,2386,86,56
"17UBGE","Belper Central",4949,2438,2511,4903,46,49
"17UBGF","Belper East",6027,3038,2989,6027,0,41
"17UBGG","Belper North",4729,2286,2443,4686,43,51
"17UBGH","Belper South",4843,2374,2469,4746,97,40
"17UBGJ","Codnor and Waingroves",4966,2457,2509,4911,55,42
"17UBGK","Crich",2281,1156,1125,2280,3,24
"17UBGL","Duffield",4585,2250,2335,4521,64,148
"17UBGM","Heage and Ambergate",4743,2360,2383,4719,24,53
"17UBGN","Heanor and Loscoe",5147,2483,2664,5142,5,18
"17UBGP","Heanor East",5289,2586,2703,5261,28,22
"17UBGQ","Heanor West",5604,2766,2838,5516,88,27
"17UBGR","Ironville and Riddings",5487,2699,2788,5440,47,34
"17UBGS","Kilburn, Denby and Holbrook",7300,3522,3778,7196,104,57
"17UBGT","Langley Mill and Aldercar",4863,2334,2529,4841,22,7
"17UBGU","Ripley",8468,4169,4299,8389,79,44
"17UBGW","Ripley and Marehay",5694,2759,2935,5662,32,40
"17UBGX","Shipley Park, Horsley and Horsley Woodhouse",5324,2575,2749,5245,79,49
"17UBGY","Somercotes",5745,2821,2924,5745,0,28
"17UBGZ","South West Parishes",2505,1229,1276,2465,40,65
"17UBHA","Swanwick",5316,2615,2701,5278,38,62
"17UBHB","Wingfield",2206,1082,1124,2161,45,36
"17UCGB","Barlborough",3018,1514,1504,3018,0,26
"17UCGC","Blackwell",4163,2001,2162,4111,52,34
"17UCGD","Bolsover North West",3693,1852,1841,3693,0,11
"17UCGE","Bolsover South",3836,1807,2029,3762,74,22
"17UCGF","Bolsover West",3762,1831,1931,3734,28,18
"17UCGG","Clowne North",3707,1796,1911,3677,30,16
"17UCGH","Clowne South",3740,1855,1885,3663,77,27
"17UCGJ","Elmton-with-Creswell",5448,2673,2775,5351,97,11
"17UCGK","Pinxton",4039,2012,2027,4004,35,12
"17UCGL","Pleasley",3569,1736,1833,3569,0,18
"17UCGM","Scarcliffe",4090,2023,2067,4020,70,8
"17UCGN","Shirebrook East",1768,847,921,1723,45,8
"17UCGP","Shirebrook Langwith",2004,980,1024,2004,0,4
"17UCGQ","Shirebrook North West",2452,1149,1303,2353,99,4
"17UCGR","Shirebrook South East",2062,1019,1043,2015,47,6
"17UCGS","Shirebrook South West",2126,1063,1063,2126,0,10
"17UCGT","South Normanton East",4199,2085,2114,4163,36,25
"17UCGU","South Normanton West",5739,2908,2831,5683,56,44
"17UCGW","Tibshelf",4408,2155,2253,4364,44,23
"17UCGX","Whitwell",3943,1956,1987,3901,42,25
"17UDFX","Barrow Hill and New Whittington",5774,2832,2942,5748,26,30
"17UDFY","Brimington North",4178,2115,2063,4160,18,8
"17UDFZ","Brimington South",5950,2869,3081,5788,162,41
"17UDGA","Brockwell",6087,3015,3072,5950,137,68
"17UDGB","Dunston",6132,2945,3187,6094,38,35
"17UDGC","Hasland",5916,2825,3091,5840,76,61
"17UDGD","Hollingwood and Inkersall",7214,3575,3639,7151,63,27
"17UDGE","Holmebrook",4124,1984,2140,4124,0,14
"17UDGF","Linacre",4048,2030,2018,4048,0,61
"17UDGG","Loundsley Green",3914,1877,2037,3848,66,21
"17UDGH","Lowgates and Woodthorpe",4324,2124,2200,4283,41,15
"17UDGJ","Middlecroft and Poolsbrook",4205,2047,2158,4205,0,11
"17UDGK","Moor",4350,2113,2237,4291,59,18
"17UDGL","Old Whittington",4129,2010,2119,4054,75,17
"17UDGM","Rother",6128,2960,3168,6128,0,25
"17UDGN","St Helen's",4126,2022,2104,4053,73,24
"17UDGP","St Leonard's",6239,3074,3165,6073,166,50
"17UDGQ","Walton",5971,2937,3034,5932,39,101
"17UDGR","West",6036,2886,3150,5940,96,111
"17UFGC","Ashbourne North",3609,1733,1876,3561,48,48
"17UFGD","Ashbourne South",4035,1969,2066,3954,81,40
"17UFGE","Bakewell",4801,2250,2551,4516,285,99
"17UFGF","Bradwell",1883,944,939,1883,0,29
"17UFGG","Brailsford",1540,749,791,1511,29,24
"17UFGH","Calver",1920,929,991,1856,64,41
"17UFGJ","Carsington Water",1855,937,918,1855,0,29
"17UFGK","Chatsworth",1692,827,865,1684,8,42
"17UFGL","Clifton and Bradley",1784,879,905,1784,0,40
"17UFGM","Darley Dale",5167,2479,2688,5090,77,61
"17UFGN","Dovedale and Parwich",1742,879,863,1721,21,35
"17UFGP","Doveridge and Sudbury",2428,1462,966,1827,601,24
"17UFGQ","Hartington and Taddington",1641,832,809,1638,3,18
"17UFGR","Hathersage and Eyam",3677,1752,1925,3619,58,72
"17UFGS","Hulland",1773,890,883,1773,0,44
"17UFGT","Lathkill and Bradford",1642,809,833,1634,8,26
"17UFGU","Litton and Longstone",1652,805,847,1635,17,41
"17UFGW","Masson",3100,1537,1563,3062,38,62
"17UFGX","Matlock All Saints",5271,2632,2639,5214,57,118
"17UFGY","Matlock St Giles",5417,2572,2845,5310,107,82
"17UFGZ","Norbury",1613,817,796,1613,0,40
"17UFHA","Stanton",1888,937,951,1881,7,21
"17UFHB","Tideswell",1864,932,932,1864,0,21
"17UFHC","Winster and South Darley",1787,872,915,1735,52,39
"17UFHD","Wirksworth",5688,2838,2850,5688,0,65
"17UGGC","Abbotsford",5410,2693,2717,5347,63,30
"17UGGD","Breaston",4555,2170,2385,4496,59,50
"17UGGE","Cotmanhay",4394,2143,2251,4394,0,12
"17UGGF","Derby Road East",4844,2324,2520,4839,5,15
"17UGGG","Derby Road West",6441,3136,3305,6272,169,52
"17UGGH","Draycott",3894,1885,2009,3821,73,33
"17UGGJ","Hallam Fields",4811,2341,2470,4811,0,23
"17UGGK","Ilkeston Central",4301,2186,2115,4301,0,6
"17UGGL","Ilkeston North",4076,1967,2109,4049,27,16
"17UGGM","Kirk Hallam",6417,3085,3332,6341,76,18
"17UGGN","Little Eaton and Breadsall",3684,1822,1862,3659,25,79
"17UGGP","Little Hallam",4024,1957,2067,3868,156,26
"17UGGQ","Long Eaton Central",6022,3010,3012,5998,24,29
"17UGGR","Nottingham Road",6215,3099,3116,6156,59,26
"17UGGS","Ockbrook And Borrowash",7331,3533,3798,7224,107,62
"17UGGT","Old Park",4117,2036,2081,4102,15,11
"17UGGU","Sandiacre North",4476,2165,2311,4446,30,17
"17UGGW","Sandiacre South",4294,2114,2180,4207,87,39
"17UGGX","Sawley",6645,3254,3391,6644,0,33
"17UGGY","Stanley",2143,1014,1129,2134,9,10
"17UGGZ","West Hallam and Dale Abbey",5117,2506,2611,5030,87,60
"17UGHA","Wilsthorpe",6888,3424,3464,6888,0,35
"17UHGC","Barms",1925,969,956,1914,11,9
"17UHGD","Blackbrook",3960,1933,2027,3917,43,47
"17UHGE","Burbage",1980,981,999,1980,0,26
"17UHGF","Buxton Central",3901,1930,1971,3849,52,37
"17UHGG","Chapel East",2046,987,1059,2046,0,24
"17UHGH","Chapel West",4370,2188,2182,4341,29,47
"17UHGJ","Corbar",3589,1728,1861,3371,218,66
"17UHGK","Cote Heath",4022,2026,1996,4013,9,22
"17UHGL","Dinting",1808,891,917,1786,22,38
"17UHGM","Gamesley",2580,1220,1360,2580,0,4
"17UHGN","Hadfield North",1972,950,1022,1901,71,10
"17UHGP","Hadfield South",4478,2222,2256,4443,35,40
"17UHGQ","Hayfield",2164,1047,1117,2159,5,39
"17UHGR","Hope Valley",3812,1860,1952,3794,18,74
"17UHGS","Howard Town",4258,2121,2137,4172,86,30
"17UHGT","Limestone Peak",2281,1149,1132,2270,11,12
"17UHGU","New Mills East",4053,2027,2026,4021,32,24
"17UHGW","New Mills West",4086,2054,2032,4086,0,42
"17UHGX","Old Glossop",4007,1960,2047,4005,0,42
"17UHGY","Padfield",2616,1286,1330,2603,13,20
"17UHGZ","St John's",1883,911,972,1883,0,25
"17UHHA","Sett",2174,1127,1047,2137,37,25
"17UHHB","Simmondley",4380,2201,2179,4315,65,82
"17UHHC","Stone Bench",4457,2179,2278,4457,0,15
"17UHHD","Temple",1957,953,1004,1933,24,33
"17UHHE","Tintwistle",2233,1081,1152,2233,0,14
"17UHHF","Whaley Bridge",6228,3095,3133,6208,20,100
"17UHHG","Whitfield",2213,1095,1118,2200,13,9
"17UJGD","Ashover",1796,908,888,1732,64,42
"17UJGE","Barlow and Holmesfield",1898,925,973,1898,0,30
"17UJGF","Brampton and Walton",3556,1760,1796,3523,33,75
"17UJGG","Clay Cross North",5073,2499,2574,5005,68,24
"17UJGH","Clay Cross South",3696,1775,1921,3657,39,15
"17UJGJ","Coal Aston",3362,1636,1726,3362,0,40
"17UJGK","Dronfield North",3869,1837,2032,3770,99,23
"17UJGL","Dronfield South",5383,2664,2719,5383,0,65
"17UJGM","Dronfield Woodhouse",3566,1758,1808,3537,29,52
"17UJGN","Eckington North",3724,1837,1887,3721,3,34
"17UJGP","Eckington South",3740,1807,1933,3600,140,13
"17UJGQ","Gosforth Valley",5150,2533,2617,5150,0,88
"17UJGR","Grassmoor",3863,1890,1973,3863,0,23
"17UJGS","Holmewood and Heath",3715,1775,1940,3593,122,10
"17UJGT","Killamarsh East",3795,1874,1921,3735,60,43
"17UJGU","Killamarsh West",5832,2899,2933,5832,0,42
"17UJGW","North Wingfield Central",5512,2711,2801,5468,44,25
"17UJGX","Pilsley and Morton",4832,2372,2460,4778,54,33
"17UJGY","Renishaw",2024,1002,1022,1928,96,8
"17UJGZ","Ridgeway and Marsh Lane",1664,818,846,1664,0,19
"17UJHA","Shirland",5563,2744,2819,5563,0,49
"17UJHB","Sutton",4019,1965,2054,3982,37,32
"17UJHC","Tupton",3794,1857,1937,3758,36,15
"17UJHD","Unstone",1804,882,922,1804,0,10
"17UJHE","Wingerworth",5710,2836,2874,5710,0,92
"17UKFW","Aston",6120,3067,3053,6025,95,83
"17UKFX","Church Gresley",4805,2384,2421,4744,61,29
"17UKFY","Etwall",4359,2092,2267,4206,153,73
"17UKFZ","Hartshorne and Ticknall",4647,2268,2379,4591,56,35
"17UKGA","Hatton",2451,1232,1219,2447,4,23
"17UKGB","Hilton",3909,1990,1919,3909,0,41
"17UKGC","Linton",4700,2358,2342,4687,13,36
"17UKGD","Melbourne",4599,2232,2367,4578,21,68
"17UKGE","Midway",7229,3572,3657,7226,3,35
"17UKGF","Newhall and Stanton",6963,3436,3527,6935,28,42
"17UKGG","North West",2196,1045,1151,2035,161,51
"17UKGH","Repton",4635,2360,2275,4003,632,112
"17UKGJ","Seales",4723,2324,2399,4664,59,52
"17UKGK","Stenson",4520,2297,2223,4520,0,54
"17UKGL","Swadlincote",6522,3201,3321,6484,38,45
"17UKGM","Willington and Findern",4294,2100,2194,4278,16,50
"17UKGN","Woodville",4890,2447,2443,4863,27,14
"18UBGN","Axminster Rural",2186,1070,1116,2186,0,23
"18UBGP","Axminster Town",3917,1835,2082,3801,116,25
"18UBGQ","Beer and Branscombe",1908,912,996,1892,16,25
"18UBGR","Broadclyst",4684,2256,2428,4606,78,61
"18UBGS","Budleigh",5570,2477,3093,5447,123,58
"18UBGT","Clyst Valley",2171,1056,1115,2154,17,42
"18UBGU","Coly Valley",4280,2046,2234,4216,64,69
"18UBGW","Dunkeswell",1926,933,993,1881,45,22
"18UBGX","Exe Valley",1949,947,1002,1949,0,29
"18UBGY","Exmouth Brixington",6169,2937,3232,6098,71,73
"18UBGZ","Exmouth Halsdon",6314,2960,3354,6218,96,94
"18UBHA","Exmouth Littleham",6629,2872,3757,6041,588,77
"18UBHB","Exmouth Town",6486,2956,3530,6366,120,43
"18UBHC","Exmouth Withycombe Raleigh",7374,3441,3933,7324,50,64
"18UBHD","Feniton and Buckerell",2292,1108,1184,2254,38,31
"18UBHE","Honiton St Michael's",6918,3326,3592,6893,25,47
"18UBHF","Honiton St Paul's",4295,2032,2263,4228,67,39
"18UBHG","Newbridges",2289,1092,1197,2244,45,31
"18UBHH","Newton Poppleford and Harpford",2014,933,1081,2014,0,31
"18UBHJ","Otterhead",2183,1106,1077,2164,19,42
"18UBHK","Ottery St Mary Rural",3853,1844,2009,3806,47,93
"18UBHL","Ottery St Mary Town",4366,2030,2336,4321,45,62
"18UBHM","Raleigh",2145,1024,1121,1964,181,33
"18UBHN","Seaton",6798,3123,3675,6554,244,62
"18UBHP","Sidmouth Rural",2047,955,1092,1975,72,27
"18UBHQ","Sidmouth Sidford",5934,2758,3176,5907,27,60
"18UBHR","Sidmouth Town",5154,2200,2954,4720,434,66
"18UBHS","Tale Vale",2369,1149,1220,2369,0,50
"18UBHT","Trinity",2170,1044,1126,2111,59,40
"18UBHU","Whimple",2161,1060,1101,2155,6,42
"18UBHW","Woodbury and Lympstone",4661,2569,2092,3890,771,83
"18UBHX","Yarty",2308,1152,1156,2298,10,31
"18UCFU","Alphington",8520,4136,4384,8306,214,57
"18UCFW","Cowick",5655,2680,2975,5539,116,26
"18UCFX","Duryard",4875,2427,2448,2378,2497,63
"18UCFY","Exwick",8988,4469,4519,8988,0,64
"18UCFZ","Heavitree",5398,2607,2791,5207,191,35
"18UCGA","Mincinglake",5668,2765,2903,5644,24,45
"18UCGB","Newtown",5337,2550,2787,4916,421,34
"18UCGC","Pennsylvania",5402,2593,2809,5375,27,88
"18UCGD","Pinhoe",6108,2889,3219,6081,27,49
"18UCGE","Polsloe",6197,3145,3052,6167,30,48
"18UCGF","Priory",9378,4516,4862,9104,274,52
"18UCGG","St David's",4813,2450,2363,4250,563,37
"18UCGH","St James",6376,3264,3112,5596,780,53
"18UCGJ","St Leonard's",4504,2078,2426,4388,116,94
"18UCGK","St Loyes",4699,2311,2388,4691,8,42
"18UCGL","St Thomas",6246,3063,3183,6165,81,31
"18UCGM","Topsham",5023,2278,2745,4991,32,67
"18UCGN","Whipton & Barton",7889,3723,4166,7837,52,43
"18UDGF","Boniface",3456,1687,1769,3412,44,44
"18UDGG","Bradninch",1775,819,956,1760,15,21
"18UDGH","Cadbury",1436,724,712,1434,3,40
"18UDGJ","Canonsleigh",3054,1514,1540,3053,0,43
"18UDGK","Castle",3296,1593,1703,3210,86,44
"18UDGL","Clare and Shuttern",3203,1570,1633,3169,34,57
"18UDGM","Cranmore",4821,2288,2533,4766,55,45
"18UDGN","Cullompton North",3299,1617,1682,3210,89,41
"18UDGP","Cullompton Outer",1844,924,920,1813,31,30
"18UDGQ","Cullompton South",3599,1773,1826,3546,53,23
"18UDGR","Halberton",1851,929,922,1821,30,22
"18UDGS","Lawrence",3381,1594,1787,3291,90,36
"18UDGT","Lower Culm",4979,2415,2564,4946,33,43
"18UDGU","Lowman",5229,2532,2697,5089,140,32
"18UDGW","Newbrooke",1528,746,782,1502,26,18
"18UDGX","Sandford and Creedy",3208,1616,1592,3176,32,56
"18UDGY","Silverton",1802,851,951,1802,0,22
"18UDGZ","Taw",1508,751,757,1508,0,18
"18UDHA","Taw Vale",1614,800,814,1580,34,16
"18UDHB","Upper Culm",3564,1754,1810,3554,10,44
"18UDHC","Upper Yeo",1561,787,774,1553,8,29
"18UDHD","Way",1515,747,768,1515,0,22
"18UDHE","Westexe",5275,2585,2690,5216,59,45
"18UDHF","Yeo",2976,1481,1495,2960,16,49
"18UEGH","Bickington and Roundswell",4196,1984,2212,4188,8,41
"18UEGJ","Bishop's Nympton",1888,923,965,1844,44,24
"18UEGK","Bratton Fleming",1907,945,962,1835,72,29
"18UEGL","Braunton East",3705,1732,1973,3634,71,65
"18UEGM","Braunton West",3805,1802,2003,3778,27,45
"18UEGN","Central Town",4574,2245,2329,4500,74,28
"18UEGP","Chittlehampton",2175,1083,1092,2175,0,33
"18UEGQ","Chulmleigh",2087,1024,1063,2082,5,32
"18UEGR","Combe Martin",3839,1878,1961,3780,59,40
"18UEGS","Forches and Whiddon Valley",4405,2138,2267,4397,8,23
"18UEGT","Fremington",3923,1850,2073,3864,59,39
"18UEGU","Georgeham and Mortehoe",3613,1776,1837,3602,11,61
"18UEGW","Heanton Punchardon",2085,1089,996,1887,198,30
"18UEGX","Ilfracombe Central",4105,2030,2075,3704,401,27
"18UEGY","Ilfracombe East",2359,1166,1193,2295,64,20
"18UEGZ","Ilfracombe West",4376,2111,2265,4309,67,32
"18UEHA","Instow",1563,727,836,1477,86,26
"18UEHB","Landkey, Swimbridge and Taw",4991,2461,2530,4937,54,84
"18UEHC","Longbridge",3994,1932,2062,3948,46,44
"18UEHD","Lynton and Lynmouth",1738,853,885,1571,167,19
"18UEHE","Marwood",1756,906,850,1756,0,45
"18UEHF","Newport",3937,1864,2073,3828,109,57
"18UEHG","North Molton",2129,1075,1054,2013,116,40
"18UEHH","Pilton",3991,1866,2125,3931,60,66
"18UEHJ","South Molton",4093,1966,2127,3983,110,61
"18UEHK","Witheridge",2040,1002,1038,2016,24,22
"18UEHL","Yeo Valley",4234,2061,2173,4220,14,32
"18UGGM","Allington and Loddiswell",2031,1000,1031,2031,0,42
"18UGGN","Avon and Harbourne",2148,1076,1072,2148,0,48
"18UGGP","Bickleigh and Shaugh",5063,2729,2334,4509,554,36
"18UGGQ","Charterlands",1972,963,1009,1914,58,31
"18UGGR","Cornwood and Sparkwell",2311,1148,1163,2309,0,25
"18UGGS","Dartington",1917,913,1004,1718,199,35
"18UGGT","Dartmouth and Kingswear",4513,2136,2377,4432,81,63
"18UGGU","Dartmouth Townstal",2331,1167,1164,2323,8,16
"18UGGW","East Dart",1788,883,905,1784,4,44
"18UGGX","Eastmoor",2207,1075,1132,2094,113,40
"18UGGY","Erme Valley",4619,2258,2361,4557,62,88
"18UGGZ","Ivybridge Central",2182,1008,1174,2074,108,16
"18UGHA","Ivybridge Filham",5218,2540,2678,5154,64,80
"18UGHB","Ivybridge Woodlands",4656,2282,2374,4610,46,45
"18UGHC","Kingsbridge East",1985,916,1069,1944,41,21
"18UGHD","Kingsbridge North",2042,973,1069,2022,20,23
"18UGHE","Marldon",2023,995,1028,2016,7,31
"18UGHF","Newton and Noss",1743,849,894,1731,12,66
"18UGHG","Salcombe and Malborough",3351,1576,1775,3268,83,68
"18UGHH","Saltstone",1532,726,806,1523,9,29
"18UGHJ","Skerries",2005,933,1072,1897,108,37
"18UGHK","South Brent",2555,1192,1363,2515,40,29
"18UGHL","Stokenham",1949,913,1036,1868,81,30
"18UGHM","Thurlestone",1815,870,945,1764,51,52
"18UGHN","Totnes Bridgetown",3706,1752,1954,3595,111,48
"18UGHP","Totnes Town",4335,1985,2350,4280,55,66
"18UGHQ","Wembury and Brixton",4033,1943,2090,4007,26,90
"18UGHR","West Dart",1867,912,955,1840,27,50
"18UGHS","Westville and Alvington",2029,942,1087,1981,48,25
"18UGHT","Yealmpton",1923,932,991,1910,13,46
"18UHGL","Ambrook",5884,3104,2780,5210,674,103
"18UHGM","Ashburton and Buckfastleigh",7664,3680,3984,7513,151,110
"18UHGN","Bishopsteignton",2423,1151,1272,2348,75,38
"18UHGP","Bovey",7555,3617,3938,7452,103,75
"18UHGQ","Bradley",5615,2687,2928,5229,386,52
"18UHGR","Buckland and Milber",7287,3520,3767,7287,0,56
"18UHGS","Bushell",5633,2690,2943,5594,39,43
"18UHGT","Chudleigh",5472,2632,2840,5379,93,59
"18UHGU","College",5280,2503,2777,4980,300,76
"18UHGW","Dawlish Central and North East",7969,3735,4234,7644,325,70
"18UHGX","Dawlish South West",4850,2227,2623,4674,176,41
"18UHGY","Haytor",2755,1355,1400,2745,10,27
"18UHGZ","Ipplepen",2466,1177,1289,2453,13,32
"18UHHA","Kenn Valley",5569,2698,2871,5515,54,65
"18UHHB","Kenton with Starcross",3087,1521,1566,3061,26,33
"18UHHC","Kerswell-with-Combe",5489,2595,2894,5458,31,61
"18UHHD","Kingsteignton East",5811,2796,3015,5749,62,53
"18UHHE","Kingsteignton West",5381,2563,2818,5285,96,33
"18UHHF","Moorland",2723,1290,1433,2653,70,47
"18UHHG","Shaldon and Stokeinteignhead",2335,1102,1233,2315,20,33
"18UHHH","Teignbridge North",2738,1297,1441,2679,59,26
"18UHHJ","Teignmouth Central",4645,2157,2488,4330,315,50
"18UHHK","Teignmouth East",4644,2108,2536,4388,256,59
"18UHHL","Teignmouth West",5124,2454,2670,5105,19,25
"18UHHM","Teign Valley",2559,1264,1295,2552,7,62
"18UKGE","Appledore",2946,1400,1546,2907,39,29
"18UKGF","Bideford East",4837,2365,2472,4782,55,35
"18UKGG","Bideford North",5173,2555,2618,5052,121,54
"18UKGH","Bideford South",5018,2426,2592,4885,133,38
"18UKGJ","Broadheath",1672,839,833,1664,8,22
"18UKGK","Clinton",1583,816,767,1538,45,22
"18UKGL","Clovelly Bay",1616,796,820,1609,7,13
"18UKGM","Coham Bridge",1557,782,775,1557,0,14
"18UKGN","Forest",1588,788,800,1545,43,17
"18UKGP","Hartland and Bradworthy",2955,1449,1506,2953,3,54
"18UKGQ","Holsworthy",3435,1659,1776,3340,95,29
"18UKGR","Kenwith",1557,745,812,1478,79,30
"18UKGS","Monkleigh and Littleham",1363,671,692,1356,7,19
"18UKGT","Northam",5031,2355,2676,4870,161,49
"18UKGU","Orchard Hill",1694,792,902,1628,66,34
"18UKGW","Shebbear and Langtree",1642,862,780,1563,79,24
"18UKGX","Tamarside",1477,754,723,1453,24,9
"18UKGY","Three Moors",1547,763,784,1534,13,20
"18UKGZ","Torrington",5279,2530,2749,5200,79,42
"18UKHA","Two Rivers",1608,793,815,1594,14,29
"18UKHB","Waldon",1607,801,806,1601,6,20
"18UKHC","Westward Ho!",1933,948,985,1833,100,26
"18UKHD","Winkleigh",1847,931,916,1847,0,26
"18ULFY","Bere Ferrers",3066,1504,1562,3010,56,36
"18ULFZ","Bridestowe",1516,756,760,1487,29,16
"18ULGA","Buckland Monachorum",3224,1536,1688,3119,105,74
"18ULGB","Burrator",1540,746,794,1519,21,20
"18ULGC","Chagford",1470,682,788,1444,26,29
"18ULGD","Drewsteignton",1527,716,811,1504,23,40
"18ULGE","Exbourne",1482,757,725,1482,0,29
"18ULGF","Hatherleigh",1673,817,856,1673,0,16
"18ULGG","Lew Valley",1548,751,797,1548,0,20
"18ULGH","Lydford",2013,1292,721,1406,607,22
"18ULGJ","Mary Tavy",1593,776,817,1547,46,34
"18ULGK","Milton Ford",1432,737,695,1429,3,23
"18ULGL","North Tawton",1693,822,871,1693,0,10
"18ULGM","Okehampton East",3036,1495,1541,3036,0,16
"18ULGN","Okehampton West",3201,1542,1659,3090,111,47
"18ULGP","Tamarside",1484,708,776,1439,45,36
"18ULGQ","Tavistock North",4858,2365,2493,4666,192,76
"18ULGR","Tavistock South",4437,2144,2293,4098,339,90
"18ULGS","Tavistock South West",1723,774,949,1723,0,24
"18ULGT","South Tawton",1636,782,854,1623,13,20
"18ULGU","Thrushel",1453,708,745,1453,0,27
"18ULGW","Walkham",3238,1540,1698,3179,59,60
"19UCFL","Burton and Winkton",4189,2008,2181,4176,13,30
"19UCFM","Grange",4715,2254,2461,4712,3,18
"19UCFN","Highcliffe",3139,1345,1794,3048,91,8
"19UCFP","Jumpers",3900,1850,2050,3828,72,28
"19UCFQ","Mudeford and Friars Cliff",4932,2274,2658,4837,95,50
"19UCFR","North Highcliffe and Walkford",3446,1654,1792,3434,12,48
"19UCFS","Portfield",4041,1923,2118,3985,56,26
"19UCFT","Purewell and Stanpit",4069,1907,2162,4058,11,31
"19UCFU","St Catherine's and Hurn",3476,1686,1790,3476,0,40
"19UCFW","Town Centre",3622,1714,1908,3606,16,36
"19UCFX","West Highcliffe",5336,2515,2821,5257,79,31
"19UDGA","Alderholt",2793,1376,1417,2790,3,31
"19UDGB","Ameysford",2558,1214,1344,2558,0,16
"19UDGC","Colehill East",4734,2326,2408,4726,8,74
"19UDGD","Colehill West",2318,1141,1177,2309,9,68
"19UDGE","Corfe Mullen Central",5160,2506,2654,5160,0,73
"19UDGF","Corfe Mullen North",2408,1178,1230,2408,0,55
"19UDGG","Corfe Mullen South",2579,1240,1339,2579,0,36
"19UDGH","Crane",2209,1059,1150,2167,42,49
"19UDGJ","Ferndown Central",3977,1833,2144,3928,49,43
"19UDGK","Ferndown Links",4777,2237,2540,4705,72,37
"19UDGL","Handley Vale",2440,1158,1282,2440,0,71
"19UDGM","Holt",2243,1102,1141,2218,25,55
"19UDGN","Longham",1996,951,1045,1996,0,25
"19UDGP","Parley",4633,2218,2415,4576,57,65
"19UDGQ","St Leonards and St Ives East",4433,2132,2301,4257,176,65
"19UDGR","St Leonards and St Ives West",2239,1076,1163,2239,0,30
"19UDGS","Stapehill",2255,1065,1190,2189,66,15
"19UDGT","Stour",2542,1225,1317,2499,43,52
"19UDGU","Three Cross and Potterne",2571,1215,1356,2501,70,22
"19UDGW","Verwood Dewlands",4433,2171,2262,4432,0,58
"19UDGX","Verwood Newtown",2612,1234,1378,2612,0,21
"19UDGY","Verwood Stephen's Castle",4065,1948,2117,4057,8,19
"19UDGZ","West Moors",7198,3397,3801,7038,160,60
"19UDHA","Wimborne Minster",6613,2972,3641,6526,87,75
"19UEGE","Abbey",3817,1949,1868,3633,184,61
"19UEGF","Blackmore",3418,1690,1728,3385,33,75
"19UEGG","Blandford Damory Down",1888,943,945,1862,26,23
"19UEGH","Blandford Hilltop",1266,635,631,1266,0,16
"19UEGJ","Blandford Langton St Leonards",1852,918,934,1852,0,21
"19UEGK","Blandford Old Town",1633,751,882,1598,35,13
"19UEGL","Blandford Station",2106,1003,1103,2068,38,27
"19UEGM","Bourton and District",1835,896,939,1835,0,55
"19UEGN","Bulbarrow",1974,986,988,1972,3,30
"19UEGP","Cranborne Chase",1872,915,957,1871,0,52
"19UEGQ","Gillingham Town",1855,873,982,1819,36,11
"19UEGR","Hill Forts",4577,2152,2425,4045,532,107
"19UEGS","Lodbourne",1768,819,949,1742,26,14
"19UEGT","Lydden Vale",1655,838,817,1655,0,47
"19UEGU","Marnhull",1951,927,1024,1932,19,44
"19UEGW","Milton",1659,834,825,1656,3,22
"19UEGX","Motcombe and Ham",1965,970,995,1659,306,37
"19UEGY","Portman",2201,1129,1072,1614,587,24
"19UEGZ","Riversdale",1692,847,845,1670,22,18
"19UEHA","Shaftesbury Central",1846,826,1020,1797,49,17
"19UEHB","Shaftesbury Christy's",1654,816,838,1635,19,21
"19UEHC","Shaftesbury Grosvenor",1675,841,834,1675,0,22
"19UEHD","Shaftesbury Underhill",1490,686,804,1473,17,32
"19UEHE","Stour Valley",3510,1684,1826,3483,27,42
"19UEHF","The Beacon",2319,1345,974,1841,478,51
"19UEHG","The Lower Tarrants",3414,2164,1250,2151,1263,64
"19UEHH","The Stours",1756,858,898,1756,0,47
"19UEHJ","Wyke",3257,1525,1732,3207,50,49
"19UGFN","Bere Regis",1984,1007,977,1984,0,28
"19UGFP","Castle",1969,960,1009,1886,83,37
"19UGFQ","Creech Barrow",1851,907,944,1849,3,33
"19UGFR","Langton",1617,804,813,1546,71,22
"19UGFS","Lytchett Matravers",3634,1785,1849,3613,21,58
"19UGFT","Lytchett Minster and Upton East",3989,1938,2051,3989,0,33
"19UGFU","Lytchett Minster and Upton West",3584,1728,1856,3584,0,46
"19UGFW","St. Martin",2752,1373,1379,2752,0,37
"19UGFX","Swanage North",4169,1875,2294,3646,523,47
"19UGFY","Swanage South",5955,2833,3122,5897,58,67
"19UGFZ","Wareham",5665,2700,2965,5622,43,66
"19UGGA","West Purbeck",1513,779,734,1457,56,22
"19UGGB","Winfrith",1616,814,802,1592,24,37
"19UGGC","Wool",4118,2018,2100,4118,0,59
"19UHGR","Beaminster",3919,1862,2057,3909,10,41
"19UHGS","Bradford Abbas",1919,915,1004,1918,0,30
"19UHGT","Bradpole",2060,972,1088,2025,35,22
"19UHGU","Bridport North",4232,1963,2269,4197,35,40
"19UHGW","Bridport South and Bothenhampton",5182,2413,2769,5074,108,49
"19UHGX","Broadmayne",1864,894,970,1852,12,47
"19UHGY","Broadwindsor",1650,825,825,1590,60,35
"19UHGZ","Burton Bradstock",1850,865,985,1850,0,32
"19UHHA","Cam Vale",2047,948,1099,1914,133,62
"19UHHB","Charminster and Cerne Valley",3731,1761,1970,3622,109,63
"19UHHC","Charmouth",1687,780,907,1634,53,23
"19UHHD","Chesil Bank",2118,1004,1114,2105,13,54
"19UHHE","Chickerell",5282,2607,2675,5222,60,40
"19UHHF","Chideock and Symondsbury",1706,821,885,1706,0,33
"19UHHG","Dorchester East",4429,2131,2298,4426,3,55
"19UHHH","Dorchester North",3490,1628,1862,3276,214,43
"19UHHJ","Dorchester South",4054,1971,2083,4036,18,94
"19UHHK","Dorchester West",4198,2025,2173,4075,123,78
"19UHHL","Frome Valley",1936,954,982,1916,20,43
"19UHHM","Halstock",1782,899,883,1750,32,35
"19UHHN","Loders",1813,855,958,1783,30,42
"19UHHP","Lyme Regis",3513,1595,1918,3344,169,32
"19UHHQ","Maiden Newton",1844,866,978,1825,19,43
"19UHHR","Marshwood Vale",1707,837,870,1707,0,33
"19UHHS","Netherbury",1890,906,984,1890,0,42
"19UHHT","Owermoigne",3431,1669,1762,3355,76,48
"19UHHU","Piddle Valley",1974,954,1020,1974,0,59
"19UHHW","Puddletown",2133,1046,1087,2133,0,26
"19UHHX","Queen Thorne",1950,970,980,1950,0,64
"19UHHY","Sherborne East",4070,1849,2221,3865,205,55
"19UHHZ","Sherborne West",5280,2554,2726,4182,1098,65
"19UHJA","Winterborne St Martin",2026,961,1065,1947,79,37
"19UHJB","Yetminster",1593,775,818,1593,0,42
"19UJFQ","Littlemoor",3633,1720,1913,3633,0,15
"19UJFR","Melcombe Regis",5510,2768,2742,5109,401,39
"19UJFS","Preston",4863,2315,2548,4802,61,90
"19UJFT","Radipole",3647,1699,1948,3490,157,48
"19UJFU","Tophill East",3564,1966,1598,3114,450,33
"19UJFW","Tophill West",4867,2356,2511,4867,0,22
"19UJFX","Underhill",4349,2516,1833,3678,671,29
"19UJFY","Upwey and Broadwey",3665,1729,1936,3594,71,46
"19UJFZ","Westham East",3496,1739,1757,3459,37,23
"19UJGA","Westham North",4980,2402,2578,4980,0,36
"19UJGB","Westham West",3458,1625,1833,3423,35,31
"19UJGC","Wey Valley",3424,1627,1797,3331,93,58
"19UJGD","Weymouth East",3518,1687,1831,3433,85,34
"19UJGE","Weymouth West",5216,2488,2728,5107,109,57
"19UJGF","Wyke Regis",5458,2623,2835,5446,12,51
"20UBFT","Bournmoor",2890,1403,1487,2844,46,27
"20UBFU","Chester Central",2670,1238,1432,2670,0,6
"20UBFW","Chester East",3348,1544,1804,3268,80,29
"20UBFX","Chester North",4655,2227,2428,4655,0,39
"20UBFY","Chester South",3236,1577,1659,3212,24,22
"20UBFZ","Chester West",3456,1592,1864,3356,100,12
"20UBGA","Edmondsley and Waldridge",5048,2530,2518,5048,0,46
"20UBGB","Grange Villa and West Pelton",1605,800,805,1585,20,6
"20UBGC","Kimblesworth and Plawsworth",1678,847,831,1596,82,8
"20UBGD","Lumley",4573,2232,2341,4538,35,47
"20UBGE","North Lodge",2907,1392,1515,2907,0,34
"20UBGF","Ouston",2921,1453,1468,2885,36,28
"20UBGG","Pelton",5249,2562,2687,5212,37,15
"20UBGH","Pelton Fell",1474,732,742,1474,0,5
"20UBGJ","Sacriston",4724,2304,2420,4683,41,20
"20UBGK","Urpeth",3258,1648,1610,3258,0,30
"20UDGA","Annfield Plain",4541,2199,2342,4446,95,8
"20UDGB","Benfieldside",4575,2169,2406,4528,47,64
"20UDGC","Blackhill",5067,2435,2632,5028,39,27
"20UDGD","Burnhope",1335,665,670,1335,0,7
"20UDGE","Burnopfield",4623,2243,2380,4565,58,25
"20UDGF","Castleside",1527,758,769,1527,0,10
"20UDGG","Catchgate",3022,1530,1492,3012,10,13
"20UDGH","Consett East",1548,782,766,1542,6,12
"20UDGJ","Consett North",4426,2107,2319,4301,125,28
"20UDGK","Consett South",3231,1559,1672,3218,13,11
"20UDGL","Cornsay",1625,803,822,1625,0,18
"20UDGM","Craghead and South Stanley",5022,2420,2602,5022,0,17
"20UDGN","Delves Lane",4596,2254,2342,4539,57,17
"20UDGP","Dipton",2925,1417,1508,2885,40,18
"20UDGQ","Ebchester and Medomsley",4739,2297,2442,4545,194,56
"20UDGR","Esh",5023,2442,2581,4902,121,36
"20UDGS","Havannah",4659,2269,2390,4552,107,22
"20UDGT","Lanchester",4381,2094,2287,4297,84,85
"20UDGU","Leadgate",4453,2152,2301,4367,86,23
"20UDGW","South Moor",4586,2237,2349,4586,0,10
"20UDGX","Stanley Hall",4665,2214,2451,4605,60,14
"20UDGY","Tanfield",4505,2222,2283,4479,26,28
"20UEGB","Bearpark and Witton Gilbert",4456,2208,2248,4358,98,36
"20UEGC","Belmont",3665,1776,1889,3600,65,94
"20UEGD","Brancepeth, Langley Moor and Meadowfield",3707,1850,1857,3707,0,42
"20UEGE","Brandon",5779,2786,2993,5697,82,35
"20UEGF","Carrville and Gilesgate Moor",5274,2557,2717,5244,30,47
"20UEGG","Cassop-cum-Quarrington",5586,2717,2869,5584,3,38
"20UEGH","Coxhoe",5543,2729,2814,5528,15,21
"20UEGJ","Crossgate and Framwelgate",4791,2415,2376,4623,168,107
"20UEGK","Deerness",3585,1781,1804,3585,0,20
"20UEGL","Elvet",5032,2382,2650,1617,3415,9
"20UEGM","Framwellgate Moor",6183,3240,2943,5308,875,54
"20UEGN","Neville's Cross",3061,1512,1549,2860,201,93
"20UEGP","New Brancepeth and Ushaw Moor",5107,2496,2611,5107,0,58
"20UEGQ","Newton Hall North",3158,1561,1597,3158,0,57
"20UEGR","Newton Hall South",3931,1915,2016,3931,0,62
"20UEGS","Pelaw and Gilesgate",4979,2395,2584,4979,0,25
"20UEGT","Pittington and West Rainton",3823,1864,1959,3776,47,33
"20UEGU","St Nicholas",3360,1754,1606,1537,1823,24
"20UEGW","Shadforth and Sherburn",4961,2416,2545,4936,25,23
"20UEGX","Shincliffe",1728,827,901,1627,101,45
"20UFGD","Acre Rigg",4117,1970,2147,4117,0,11
"20UFGE","Blackhalls",5358,2595,2763,5242,116,18
"20UFGF","Dawdon",5476,2700,2776,5415,61,13
"20UFGG","Dene House",3808,1790,2018,3682,126,12
"20UFGH","Deneside",5595,2688,2907,5595,0,13
"20UFGJ","Easington Colliery",4959,2387,2572,4947,12,15
"20UFGK","Easington Village and South Hetton",5142,2526,2616,5105,37,32
"20UFGL","Eden Hill",4187,1982,2205,4109,78,9
"20UFGM","Haswell and Shotton",5873,2867,3006,5846,27,20
"20UFGN","Horden North",4977,2415,2562,4951,26,10
"20UFGP","Horden South",3547,1740,1807,3509,38,6
"20UFGQ","Howletch",3848,1861,1987,3820,28,22
"20UFGR","Hutton Henry",1786,848,938,1780,6,25
"20UFGS","Murton East",3648,1777,1871,3648,0,14
"20UFGT","Murton West",3595,1685,1910,3519,76,18
"20UFGU","Passfield",5902,2944,2958,5902,0,48
"20UFGW","Seaham Harbour",5284,2471,2813,5122,162,15
"20UFGX","Seaham North",5105,2506,2599,5060,45,18
"20UFGY","Thornley and Wheatley Hill",5707,2831,2876,5685,22,19
"20UFGZ","Wingate",6079,2948,3131,5971,108,19
"20UGFZ","Bishop Middleham and Cornforth",3744,1795,1949,3708,36,29
"20UGGA","Broom",4855,2336,2519,4855,0,18
"20UGGB","Byerley",3296,1593,1703,3275,21,16
"20UGGC","Chilton",5184,2561,2623,5184,0,22
"20UGGD","Ferryhill",4747,2268,2479,4668,79,25
"20UGGE","Fishburn and Old Trimdon",5461,2678,2783,5424,37,22
"20UGGF","Greenfield Middridge",5527,2711,2816,5444,83,63
"20UGGG","Low Spennymoor and Tudhoe Grange",5446,2592,2854,5443,3,50
"20UGGH","Middlestone",5040,2481,2559,4998,42,50
"20UGGJ","Neville and Simpasture",4722,2260,2462,4722,0,9
"20UGGK","New Trimdon and Trimdon Grange",1903,946,957,1883,20,3
"20UGGL","Sedgefield",4943,2405,2538,4897,46,64
"20UGGM","Shafto St Marys",5417,2572,2845,5311,106,34
"20UGGN","Spennymoor",5181,2527,2654,5139,42,35
"20UGGP","Sunnydale",3548,1729,1819,3511,37,13
"20UGGQ","Thickley",3651,1758,1893,3651,0,9
"20UGGR","Tudhoe",3482,1683,1799,3476,6,34
"20UGGS","West",5669,2705,2964,5669,0,35
"20UGGT","Woodham",5390,2686,2704,5356,34,62
"20UHFW","Barnard Castle East",1714,816,898,1527,187,11
"20UHFX","Barnard Castle North",1499,694,805,1424,75,8
"20UHFY","Barnard Castle West",2189,1050,1139,2147,42,35
"20UHFZ","Barningham and Ovington",614,311,303,614,0,16
"20UHGA","Cockfield",1545,741,804,1545,0,4
"20UHGB","Cotherstone with Lartington",685,331,354,683,3,10
"20UHGC","Eggleston",754,377,377,752,0,12
"20UHGD","Etherley",2431,1187,1244,2369,62,16
"20UHGE","Evenwood, Ramshaw and Lands",2288,1114,1174,2288,0,20
"20UHGF","Gainford and Winston",1532,745,787,1532,0,25
"20UHGG","Greta",722,378,344,722,0,18
"20UHGH","Hamsterley and South Bedburn",557,289,268,557,0,10
"20UHGJ","Ingleton",670,331,339,670,0,11
"20UHGK","Lynesack",1416,705,711,1416,0,7
"20UHGL","Middleton-in-Teesdale",1456,715,741,1446,10,15
"20UHGM","Romaldkirk",881,435,446,881,0,14
"20UHGN","Staindrop",1479,710,769,1479,0,15
"20UHGP","Startforth",1312,850,462,926,386,23
"20UHGQ","Streatlam and Whorlton",713,349,364,682,31,13
"20UJFY","Bishop Auckland Town",2764,1321,1443,2680,84,29
"20UJFZ","Cockton Hill",4603,2199,2404,4591,12,65
"20UJGA","Coundon",4316,2152,2164,4292,24,14
"20UJGB","Crook North",1635,771,864,1623,12,9
"20UJGC","Crook South",4662,2247,2415,4599,63,40
"20UJGD","Dene Valley",2806,1321,1485,2738,68,10
"20UJGE","Escomb",3323,1658,1665,3320,3,23
"20UJGF","Henknowle",3874,1786,2088,3799,75,16
"20UJGG","Howden",1493,733,760,1491,3,14
"20UJGH","Hunwick",1533,750,783,1533,0,16
"20UJGJ","St John's Chapel",1432,706,726,1432,0,17
"20UJGK","Stanhope",3375,1631,1744,3300,75,34
"20UJGL","Tow Law and Stanley",3828,1844,1984,3767,61,21
"20UJGM","West Auckland",4347,2048,2299,4239,108,22
"20UJGN","Wheatbottom and Helmington Row",2937,1353,1584,2916,21,13
"20UJGP","Willington Central",5383,2593,2790,5241,142,27
"20UJGQ","Willington West End",1244,609,635,1231,13,16
"20UJGR","Wolsingham and Witton-le-Wear",2968,1447,1521,2968,0,70
"20UJGS","Woodhouse Close",4816,2264,2552,4811,5,16
"21UCFL","Devonshire",11108,5335,5773,10946,162,52
"21UCFM","Hampden Park",10576,4992,5584,10458,118,58
"21UCFN","Langney",11118,5241,5877,11070,48,50
"21UCFP","Meads",9785,4241,5544,8493,1292,72
"21UCFQ","Old Town",10731,5016,5715,10607,124,169
"21UCFR","Ratton",9384,4319,5065,9227,157,106
"21UCFS","St Anthony's",10777,5110,5667,10637,140,58
"21UCFT","Sovereign",7014,3334,3680,6991,23,48
"21UCFU","Upperton",9174,4062,5112,8390,784,84
"21UDFS","Ashdown",5158,2520,2638,5111,47,51
"21UDFT","Baird",5243,2524,2719,5084,159,32
"21UDFU","Braybrooke",5178,2522,2656,5029,149,47
"21UDFW","Castle",6091,2977,3114,6055,36,30
"21UDFX","Central St Leonards",5775,2817,2958,5643,132,27
"21UDFY","Conquest",4985,2375,2610,4846,139,50
"21UDFZ","Gensing",5808,2867,2941,5499,309,35
"21UDGA","Hollington",6347,3026,3321,6347,0,19
"21UDGB","Maze Hill",5069,2260,2809,4557,512,41
"21UDGC","Old Hastings",5812,2727,3085,5704,108,49
"21UDGD","Ore",5117,2462,2655,5053,64,32
"21UDGE","St Helens",4943,2371,2572,4884,59,53
"21UDGF","Silverhill",4666,2171,2495,4582,84,42
"21UDGG","Tressell",4975,2371,2604,4960,15,21
"21UDGH","West St Leonards",4907,2371,2536,4808,99,43
"21UDGJ","Wishing Tree",4955,2301,2654,4919,36,31
"21UFGG","Barcombe and Hamsey",1976,984,992,1970,6,37
"21UFGH","Chailey and Wivelsfield",4684,2308,2376,4655,29,124
"21UFGJ","Ditchling and Westmeston",2099,898,1201,1876,223,45
"21UFGK","East Saltdean and Telscombe Cliffs",7133,3394,3739,7008,125,49
"21UFGL","Kingston",2038,988,1050,1972,66,37
"21UFGM","Lewes Bridge",4255,2051,2204,4253,3,32
"21UFGN","Lewes Castle",4571,2177,2394,4490,81,60
"21UFGP","Lewes Priory",7162,3489,3673,6875,287,101
"21UFGQ","Newhaven Denton and Meeching",7294,3589,3705,7193,101,32
"21UFGR","Newhaven Valley",3877,1896,1981,3871,6,10
"21UFGS","Newick",2318,1115,1203,2297,21,51
"21UFGT","Ouse Valley and Ringmer",6421,3081,3340,6352,69,89
"21UFGU","Peacehaven East",4319,2038,2281,4231,88,22
"21UFGW","Peacehaven North",4859,2427,2432,4839,20,26
"21UFGX","Peacehaven West",4039,1888,2151,4033,6,14
"21UFGY","Plumpton, Streat, East Chiltington and St John (Without)",2306,1098,1208,2190,116,49
"21UFGZ","Seaford Central",4629,2107,2522,4456,173,34
"21UFHA","Seaford East",4783,2276,2507,4644,139,40
"21UFHB","Seaford North",4838,2279,2559,4758,80,48
"21UFHC","Seaford South",4208,1921,2287,3999,209,70
"21UFHD","Seaford West",4368,2038,2330,4255,113,39
"21UGGD","Battle Town",4780,2201,2579,4666,114,74
"21UGGE","Brede Valley",4627,2230,2397,4559,68,78
"21UGGF","Central",4947,2196,2751,4740,207,35
"21UGGG","Collington",4248,1867,2381,4016,232,54
"21UGGH","Crowhurst",2583,1240,1343,2465,118,56
"21UGGJ","Darwell",4882,2404,2478,4656,226,80
"21UGGK","Eastern Rother",4713,2287,2426,4705,8,53
"21UGGL","Ewhurst and Sedlescombe",2372,1163,1209,2312,60,50
"21UGGM","Kewhurst",4605,2036,2569,4526,79,51
"21UGGN","Marsham",3697,1755,1942,3675,22,42
"21UGGP","Old Town",3798,1679,2119,3506,292,30
"21UGGQ","Rother Levels",4627,2232,2395,4522,105,86
"21UGGR","Rye",4009,1860,2149,3984,25,27
"21UGGS","Sackville",4213,1762,2451,3865,348,27
"21UGGT","St Marks",4542,2225,2317,4215,327,55
"21UGGU","St Michaels",4615,2096,2519,4301,314,32
"21UGGW","St Stephens",4189,1931,2258,4170,19,37
"21UGGX","Salehurst",4484,2216,2268,4238,246,70
"21UGGY","Sidley",5338,2501,2837,5298,40,29
"21UGGZ","Ticehurst and Etchingham",4159,1999,2160,4129,30,84
"21UHGM","Alfriston",2295,1045,1250,2283,12,37
"21UHGN","Buxted and Maresfield",4969,2428,2541,4885,84,139
"21UHGP","Chiddingly and East Hoathly",2727,1334,1393,2656,71,66
"21UHGQ","Cross in Hand/Five Ashes",2291,1086,1205,2192,99,47
"21UHGR","Crowborough East",5247,2613,2634,4956,291,60
"21UHGS","Crowborough Jarvis Brook",2686,1352,1334,2677,9,29
"21UHGT","Crowborough North",5054,2454,2600,5036,18,97
"21UHGU","Crowborough St. Johns",2193,1072,1121,2156,37,60
"21UHGW","Crowborough West",4759,2218,2541,4533,226,111
"21UHGX","Danehill/Fletching/Nutley",5049,2401,2648,4626,423,150
"21UHGY","East Dean",2164,1037,1127,2144,20,44
"21UHGZ","Forest Row",5198,2482,2716,4871,327,140
"21UHHA","Framfield",2544,1210,1334,2528,16,63
"21UHHB","Frant/Withyham",4791,2365,2426,4745,46,133
"21UHHC","Hailsham Central and North",5500,2576,2924,5414,86,55
"21UHHD","Hailsham East",2769,1289,1480,2747,22,15
"21UHHE","Hailsham South and West",8330,3912,4418,8160,170,58
"21UHHF","Hartfield",2523,1220,1303,2460,63,87
"21UHHG","Heathfield East",2351,1157,1194,2290,61,65
"21UHHH","Heathfield North and Central",7722,3758,3964,7710,12,87
"21UHHJ","Hellingly",4974,2433,2541,4854,120,66
"21UHHK","Herstmonceux",2532,1226,1306,2511,21,28
"21UHHL","Horam",2578,1200,1378,2498,80,26
"21UHHM","Mayfield",2677,1170,1507,2483,194,61
"21UHHN","Ninfield and Hooe with Wartling",2327,1125,1202,2306,21,42
"21UHHP","Pevensey and Westham",8545,4009,4536,8502,43,74
"21UHHQ","Polegate North",4713,2121,2592,4583,130,28
"21UHHR","Polegate South",2250,982,1268,2190,60,9
"21UHHS","Rotherfield",2327,1112,1215,2319,8,59
"21UHHT","Uckfield Central",2792,1316,1476,2759,33,61
"21UHHU","Uckfield New Town",2559,1283,1276,2559,0,26
"21UHHW","Uckfield North",5372,2619,2753,5372,0,58
"21UHHX","Uckfield Ridgewood",2974,1452,1522,2875,99,38
"21UHHY","Wadhurst",5057,2390,2667,4841,216,139
"21UHHZ","Willingdon",7184,3271,3913,7164,20,73
"22UBFQ","Billericay East",11472,5659,5813,11461,11,209
"22UBFR","Billericay West",11934,5799,6135,11857,77,202
"22UBFS","Burstead",10417,5098,5319,10398,19,170
"22UBFT","Crouch",7491,3723,3768,7483,8,56
"22UBFU","Fryerns",12178,5697,6481,12004,174,29
"22UBFW","Laindon Park",11026,5249,5777,10968,58,50
"22UBFX","Langdon Hills",8762,4340,4422,8705,57,69
"22UBFY","Lee Chapel North",12102,5727,6375,12102,0,48
"22UBFZ","Nethermayne",11160,5284,5876,11083,77,61
"22UBGA","Pitsea North West",12901,6176,6725,12838,63,48
"22UBGB","Pitsea South East",11650,5697,5953,11591,59,71
"22UBGC","St Martin's",7641,3674,3967,7603,38,31
"22UBGD","Vange",9571,4576,4995,9567,4,19
"22UBGE","Wickford Castledon",7555,3639,3916,7472,83,47
"22UBGF","Wickford North",11843,5773,6070,11800,43,68
"22UBGG","Wickford Park",7965,3924,4041,7965,0,23
"22UCGL","Black Notley and Terling",3298,1659,1639,3272,26,31
"22UCGM","Bocking Blackwater",7962,3969,3993,7841,121,54
"22UCGN","Bocking North",4215,2004,2211,3985,230,23
"22UCGP","Bocking South",4978,2380,2598,4969,9,43
"22UCGQ","Bradwell, Silver End and Rivenhall",4985,2489,2496,4911,74,35
"22UCGR","Braintree Central",6502,3224,3278,6468,34,69
"22UCGS","Braintree East",6118,2958,3160,6077,41,26
"22UCGT","Braintree South",6535,3299,3236,6535,0,32
"22UCGU","Bumpstead",2418,1178,1240,2402,16,50
"22UCGW","Coggeshall and North Feering",4778,2345,2433,4730,48,71
"22UCGX","Cressing and Stisted",2155,1066,1089,2114,41,20
"22UCGY","Gosfield and Greenstead Green",2460,1198,1262,2379,81,45
"22UCGZ","Great Notley and Braintree West",5420,2683,2737,5414,6,47
"22UCHA","Halstead St Andrew's",6280,3061,3219,6203,77,60
"22UCHB","Halstead Trinity",4773,2358,2415,4726,47,26
"22UCHC","Hatfield Peverel",4384,2146,2238,4261,123,63
"22UCHD","Hedingham and Maplestead",6207,3099,3108,6188,19,67
"22UCHE","Kelvedon",5019,2472,2547,4962,57,68
"22UCHF","Panfield",2036,1031,1005,2016,20,39
"22UCHG","Rayne",2162,1065,1097,2157,5,27
"22UCHH","Stour Valley North",2131,1051,1080,2131,0,53
"22UCHJ","Stour Valley South",2065,1027,1038,2051,14,55
"22UCHK","The Three Colnes",4848,2344,2504,4724,124,57
"22UCHL","Three Fields",3818,1918,1900,3793,25,68
"22UCHM","Upper Colne",2121,1049,1072,2121,0,43
"22UCHN","Witham Chipping Hill and Central",4412,2036,2376,4316,96,53
"22UCHP","Witham North",5018,2531,2487,5013,5,13
"22UCHQ","Witham South",6154,2993,3161,6149,5,50
"22UCHR","Witham West",6886,3371,3515,6886,0,45
"22UCHS","Yeldham",2041,1056,985,2029,12,23
"22UDFT","Brentwood North",5919,2784,3135,5690,229,81
"22UDFU","Brentwood South",5099,2389,2710,4967,132,47
"22UDFW","Brentwood West",4887,2425,2462,4887,0,53
"22UDFX","Brizes and Doddinghurst",5923,2899,3024,5845,78,85
"22UDFY","Herongate, Ingrave and West Horndon",3490,1705,1785,3462,28,43
"22UDFZ","Hutton Central",3674,1779,1895,3674,0,62
"22UDGA","Hutton East",3477,1662,1815,3440,37,39
"22UDGB","Hutton North",4189,2046,2143,4132,57,43
"22UDGC","Hutton South",3786,1861,1925,3786,0,75
"22UDGD","Ingatestone, Fryerning and Mountnessing",5640,2746,2894,5594,46,90
"22UDGE","Pilgrims Hatch",5908,2788,3120,5906,3,64
"22UDGF","Shenfield",5144,2529,2615,5109,35,117
"22UDGG","South Weald",1828,915,913,1805,23,21
"22UDGH","Tipps Cross",3830,1920,1910,3830,0,55
"22UDGJ","Warley",5662,2755,2907,5358,304,65
"22UEFQ","Appleton",6681,3268,3413,6681,0,45
"22UEFR","Boyce",6118,2992,3126,6043,75,76
"22UEFS","Canvey Island Central",6770,3253,3517,6726,44,19
"22UEFT","Canvey Island East",6375,3153,3222,6340,35,18
"22UEFU","Canvey Island North",5979,2918,3061,5972,7,25
"22UEFW","Canvey Island South",6347,3096,3251,6264,83,28
"22UEFX","Canvey Island West",4498,2265,2233,4498,0,17
"22UEFY","Canvey Island Winter Gardens",7510,3707,3803,7510,0,31
"22UEFZ","Cedar Hall",5641,2741,2900,5612,29,38
"22UEGA","St George's",6072,2993,3079,6072,0,43
"22UEGB","St James",6199,2980,3219,6164,35,54
"22UEGC","St Mary's",6287,3051,3236,6152,135,36
"22UEGD","St Peter's",6391,3069,3322,6272,119,53
"22UEGE","Victoria",5740,2833,2907,5735,5,47
"22UFGE","Bicknacre and East and West Hanningfield",5039,2507,2532,4977,62,79
"22UFGF","Boreham and The Leighs",5093,2474,2619,4976,117,61
"22UFGG","Broomfield and The Walthams",7477,3690,3787,7393,84,110
"22UFGH","Chelmer Village and Beaulieu Park",8406,4106,4300,8406,0,67
"22UFGJ","Chelmsford Rural West",2695,1365,1330,2695,0,40
"22UFGK","Galleywood",5898,2878,3020,5898,0,89
"22UFGL","Goat Hall",5786,2864,2922,5754,32,80
"22UFGM","Great Baddow East",7853,3841,4012,7831,22,87
"22UFGN","Great Baddow West",5164,2479,2685,5164,0,44
"22UFGP","Little Baddow, Danbury and Sandon",8091,3974,4117,8009,82,171
"22UFGQ","Marconi",6306,3097,3209,5744,562,38
"22UFGR","Moulsham and Central",8457,4231,4226,8394,63,96
"22UFGS","Moulsham Lodge",5484,2753,2731,5484,0,49
"22UFGT","Patching Hall",8776,4208,4568,8739,37,125
"22UFGU","Rettendon and Runwell",5039,2450,2589,4888,151,32
"22UFGW","St Andrews",8644,4168,4476,8634,10,115
"22UFGX","South Hanningfield, Stock and Margaretting",5179,2576,2603,5169,10,74
"22UFGY","South Woodham-Chetwood and Collingwood",8496,4252,4244,8488,8,128
"22UFGZ","South Woodham-Elmwood and Woodville",8133,4088,4045,8133,0,105
"22UFHA","Springfield North",8999,4547,4452,8925,74,74
"22UFHB","The Lawns",5610,2719,2891,5610,0,86
"22UFHC","Trinity",5830,3046,2784,5564,266,64
"22UFHD","Waterhouse Farm",4985,2420,2565,4955,30,46
"22UFHE","Writtle",5632,2695,2937,5224,408,55
"22UGGE","Berechurch",8367,4258,4109,8043,324,46
"22UGGF","Birch and Winstree",4846,2461,2385,4830,16,74
"22UGGG","Castle",7032,3403,3629,6831,201,71
"22UGGH","Christ Church",4201,2110,2091,4129,72,89
"22UGGJ","Copford and West Stanway",1876,930,946,1795,81,33
"22UGGK","Dedham and Langham",2906,1428,1478,2904,3,48
"22UGGL","East Donyland",2376,1137,1239,2376,0,17
"22UGGM","Fordham and Stour",5113,2557,2556,5040,73,91
"22UGGN","Great Tey",2764,1384,1380,2739,25,60
"22UGGP","Harbour",5701,2719,2982,5599,102,22
"22UGGQ","Highwoods",7592,3706,3886,7525,67,60
"22UGGR","Lexden",5433,2601,2832,5262,171,102
"22UGGS","Marks Tey",2566,1327,1239,2556,10,27
"22UGGT","Mile End",6215,3101,3114,5968,247,65
"22UGGU","New Town",8625,4573,4052,8066,559,42
"22UGGW","Prettygate",7730,3727,4003,7668,62,110
"22UGGX","Pyefleet",2435,1200,1235,2382,53,38
"22UGGY","St Andrew's",9362,4568,4794,9252,110,45
"22UGGZ","St Anne's",8761,4235,4526,8650,111,58
"22UGHA","St John's",5194,2578,2616,5121,73,81
"22UGHB","Shrub End",10528,5406,5122,9942,586,106
"22UGHC","Stanway",7553,3708,3845,7503,50,87
"22UGHD","Tiptree",7516,3661,3855,7495,21,63
"22UGHE","West Bergholt and Eight Ash Green",5044,2506,2538,5007,37,88
"22UGHF","West Mersea",6925,3321,3604,6915,10,78
"22UGHG","Wivenhoe Cross",4146,2016,2130,2337,1809,23
"22UGHH","Wivenhoe Quay",4989,2502,2487,4979,10,66
"22UHGH","Broadley Common, Epping Upland and Nazeing",1924,967,957,1924,0,18
"22UHGJ","Buckhurst Hill East",4281,1999,2282,4281,0,25
"22UHGK","Buckhurst Hill West",6457,3109,3348,6372,85,81
"22UHGL","Chigwell Row",2161,1059,1102,2149,12,27
"22UHGM","Chigwell Village",3937,1910,2027,3871,66,86
"22UHGN","Chipping Ongar, Greensted and Marden Ash",4115,1990,2125,4115,0,69
"22UHGP","Epping Hemnall",5997,2850,3147,5929,68,49
"22UHGQ","Epping Lindsey and Thornwood Common",5974,2929,3045,5881,93,66
"22UHGR","Grange Hill",6351,3062,3289,6277,74,78
"22UHGS","Hastingwood, Matching and Sheering Village",2172,1089,1083,2172,0,36
"22UHGT","High Ongar, Willingale and The Rodings",2081,1052,1029,2081,0,24
"22UHGU","Lambourne",1828,898,930,1828,0,14
"22UHGW","Loughton Alderton",4456,2120,2336,4456,0,20
"22UHGX","Loughton Broadway",4231,1971,2260,4231,0,10
"22UHGY","Loughton Fairmead",4453,2114,2339,4453,0,13
"22UHGZ","Loughton Forest",4214,2010,2204,4173,41,71
"22UHHA","Loughton Roding",4540,2152,2388,4537,3,19
"22UHHB","Loughton St John's",4284,2081,2203,4258,26,49
"22UHHC","Loughton St Mary's",4162,2022,2140,4114,48,73
"22UHHD","Lower Nazeing",4173,2050,2123,4173,0,45
"22UHHE","Lower Sheering",1955,1049,906,1955,0,9
"22UHHF","Moreton and Fyfield",2119,1036,1083,2119,0,42
"22UHHG","North Weald Bassett",4461,2155,2306,4308,153,26
"22UHHH","Passingford",2094,1044,1050,2094,0,24
"22UHHJ","Roydon",2139,1063,1076,2134,5,32
"22UHHK","Shelley",1954,940,1014,1948,6,7
"22UHHL","Theydon Bois",3993,1941,2052,3937,56,55
"22UHHM","Waltham Abbey High Beach",2143,1083,1060,2138,5,12
"22UHHN","Waltham Abbey Honey Lane",6178,3002,3176,6136,42,17
"22UHHP","Waltham Abbey North East",4193,2042,2151,4155,38,18
"22UHHQ","Waltham Abbey Paternoster",4330,2099,2231,4327,3,5
"22UHHR","Waltham Abbey South West",3546,1720,1826,3510,36,8
"22UJFS","Bush Fair",7493,3580,3913,7441,52,25
"22UJFT","Church Langley",7661,3815,3846,7651,10,23
"22UJFU","Great Parndon",6767,3327,3440,6767,0,51
"22UJFW","Harlow Common",7437,3600,3837,7415,22,33
"22UJFX","Little Parndon and Hare Street",7494,3598,3896,7318,176,51
"22UJFY","Mark Hall",6977,3330,3647,6934,43,37
"22UJFZ","Netteswell",7036,3409,3627,7007,29,39
"22UJGA","Old Harlow",5879,2812,3067,5803,76,48
"22UJGB","Staple Tye",7364,3564,3800,7342,22,42
"22UJGC","Sumners and Kingsmoor",7450,3750,3700,7444,6,50
"22UJGD","Toddbrook",7210,3432,3778,7166,44,37
"22UKFX","Althorne",4002,2011,1991,3983,19,21
"22UKFY","Burnham-on-Crouch North",3805,1911,1894,3796,9,46
"22UKFZ","Burnham-on-Crouch South",3954,1950,2004,3954,0,15
"22UKGA","Great Totham",3463,1712,1751,3437,26,64
"22UKGB","Heybridge East",3882,2013,1869,3882,0,35
"22UKGC","Heybridge West",3745,1819,1926,3658,87,19
"22UKGD","Maldon East",2155,1027,1128,2118,37,8
"22UKGE","Maldon North",3812,1759,2053,3770,42,36
"22UKGF","Maldon South",4056,2005,2051,4028,28,32
"22UKGG","Maldon West",4011,1993,2018,4011,0,50
"22UKGH","Mayland",3795,1888,1907,3795,0,40
"22UKGJ","Purleigh",3201,1601,1600,3201,0,67
"22UKGK","Southminster",4021,2001,2020,3979,42,30
"22UKGL","Tillingham",2181,1094,1087,2145,36,22
"22UKGM","Tollesbury",2033,1041,992,2027,6,34
"22UKGN","Tolleshunt D'Arcy",3926,1966,1960,3844,82,48
"22UKGP","Wickham Bishops and Woodham",3376,1661,1715,3376,0,97
"22ULGA","Ashingdon and Canewdon",4208,2069,2139,4115,93,27
"22ULGB","Barling and Sutton",1784,882,902,1738,46,15
"22ULGC","Downhall and Rawreth",4057,2018,2039,4057,0,32
"22ULGD","Foulness and Great Wakering",5724,2846,2878,5724,0,51
"22ULGE","Grange",3366,1637,1729,3366,0,18
"22ULGF","Hawkwell North",4369,2133,2236,4359,10,41
"22ULGG","Hawkwell South",3961,1937,2024,3961,0,27
"22ULGH","Hawkwell West",3938,1936,2002,3938,0,45
"22ULGJ","Hockley Central",6111,2916,3195,6111,0,66
"22ULGK","Hockley North",1872,942,930,1872,0,26
"22ULGL","Hockley West",2008,1005,1003,2008,0,32
"22ULGM","Hullbridge",6445,3212,3233,6445,0,47
"22ULGN","Lodge",3974,1923,2051,3965,9,41
"22ULGP","Rayleigh Central",4284,2071,2213,4284,0,43
"22ULGQ","Rochford",6870,3230,3640,6757,113,40
"22ULGR","Sweyne Park",4325,2093,2232,4311,14,24
"22ULGS","Trinity",3580,1700,1880,3455,125,48
"22ULGT","Wheatley",3885,1844,2041,3833,52,34
"22ULGU","Whitehouse",3728,1745,1983,3728,0,38
"22UNGK","Alresford",2125,1059,1066,2112,13,30
"22UNGL","Alton Park",5178,2420,2758,5165,13,20
"22UNGM","Ardleigh and Little Bromley",2370,1225,1145,2350,20,51
"22UNGN","Beaumont and Thorpe",2399,1209,1190,2381,18,32
"22UNGP","Bockings Elm",4337,2033,2304,4311,26,30
"22UNGQ","Bradfield, Wrabness and Wix",2229,1117,1112,2201,28,41
"22UNGR","Brightlingsea",8146,3975,4171,8058,88,59
"22UNGS","Burrsville",2109,1009,1100,2109,0,8
"22UNGT","Frinton",4089,1797,2292,3965,124,54
"22UNGU","Golf Green",4665,2231,2434,4611,54,10
"22UNGW","Great and Little Oakley",2306,1125,1181,2291,15,22
"22UNGX","Great Bentley",2259,1089,1170,2227,32,22
"22UNGY","Hamford",4032,1886,2146,3980,52,26
"22UNGZ","Harwich East",2581,1271,1310,2581,0,8
"22UNHA","Harwich East Central",4836,2382,2454,4732,104,33
"22UNHB","Harwich West",4450,2166,2284,4413,37,30
"22UNHC","Harwich West Central",5148,2446,2702,5135,13,26
"22UNHD","Haven",2108,957,1151,2069,39,10
"22UNHE","Holland and Kirby",4519,2216,2303,4481,38,41
"22UNHF","Homelands",2023,895,1128,1961,62,7
"22UNHG","Lawford",4476,2221,2255,4471,5,46
"22UNHH","Little Clacton and Weeley",4612,2274,2338,4559,53,32
"22UNHJ","Manningtree, Mistley, Little Bentley and Tendring",4365,2117,2248,4210,155,62
"22UNHK","Peter Bruff",4693,2284,2409,4693,0,23
"22UNHL","Pier",4810,2272,2538,4194,616,17
"22UNHM","Ramsey and Parkeston",2488,1240,1248,2403,85,27
"22UNHN","Rush Green",4979,2349,2630,4970,9,19
"22UNHP","St Bartholomews",4417,2012,2405,4383,34,20
"22UNHQ","St James",4334,2003,2331,4124,210,21
"22UNHR","St Johns",4799,2234,2565,4788,11,14
"22UNHS","St Marys",4968,2376,2592,4968,0,19
"22UNHT","St Osyth and Point Clear",4119,2010,2109,4118,0,21
"22UNHU","St Pauls",4552,2054,2498,4192,360,42
"22UNHW","Thorrington, Frating, Elmstead and Great Bromley",4642,2328,2314,4488,154,41
"22UNHX","Walton",4376,1983,2393,4187,189,23
"22UQGJ","Ashdon",1601,800,801,1601,0,43
"22UQGK","Barnston and High Easter",1507,763,744,1507,0,31
"22UQGL","Birchanger",987,490,497,952,35,12
"22UQGM","Broad Oak and the Hallingburys",3249,1635,1614,3236,13,58
"22UQGN","Clavering",1389,679,710,1389,0,35
"22UQGP","Elsenham and Henham",3602,1850,1752,3602,0,54
"22UQGQ","Felsted",3153,1554,1599,2777,376,72
"22UQGR","Great Dunmow North",2537,1236,1301,2537,0,39
"22UQGS","Great Dunmow South",4459,2147,2312,4380,79,58
"22UQGT","Hatfield Heath",1670,814,856,1652,18,25
"22UQGU","Littlebury",1623,827,796,1623,0,65
"22UQGW","Newport",3185,1589,1596,3184,3,72
"22UQGX","Saffron Walden Audley",4575,2126,2449,4517,58,89
"22UQGY","Saffron Walden Castle",4925,2419,2506,4850,75,69
"22UQGZ","Saffron Walden Shire",5106,2560,2546,4878,228,72
"22UQHA","Stansted North",3143,1579,1564,3077,66,76
"22UQHB","Stansted South",2792,1407,1385,2764,28,29
"22UQHC","Stebbing",1510,763,747,1510,0,50
"22UQHD","Stort Valley",1455,722,733,1455,0,46
"22UQHE","Takeley and the Canfields",2939,1475,1464,2937,0,34
"22UQHF","Thaxted",3146,1556,1590,3113,33,40
"22UQHG","The Chesterfords",1629,809,820,1629,0,43
"22UQHH","The Eastons",1489,758,731,1489,0,26
"22UQHJ","The Rodings",1755,866,889,1736,19,28
"22UQHK","The Sampfords",1782,880,902,1782,0,38
"22UQHL","Wenden Lofts",1435,714,721,1435,0,54
"22UQHM","Wimbish and Debden",2303,1326,977,2015,288,57
"23UBFQ","All Saints",5240,2643,2597,5176,64,65
"23UBFR","Battledown",4595,2283,2312,4569,26,110
"23UBFS","Benhall and The Reddings",5193,2562,2631,5193,0,60
"23UBFT","Charlton Kings",5514,2626,2888,5385,129,96
"23UBFU","Charlton Park",4816,2268,2548,4724,92,128
"23UBFW","College",5559,2820,2739,5078,481,83
"23UBFX","Hesters Way",5605,2669,2936,5545,60,25
"23UBFY","Lansdown",5334,2363,2971,4433,901,60
"23UBFZ","Leckhampton",5244,2534,2710,5158,86,82
"23UBGA","Oakley",5880,2805,3075,5868,12,22
"23UBGB","Park",5718,2691,3027,5026,692,75
"23UBGC","Pittville",5361,2644,2717,5057,304,68
"23UBGD","Prestbury",5272,2500,2772,5169,103,97
"23UBGE","St Mark's",5972,2911,3061,5852,120,38
"23UBGF","St Paul's",5560,2794,2766,5379,181,19
"23UBGG","St Peter's",5865,2953,2912,5803,62,34
"23UBGH","Springbank",6085,2899,3186,6040,45,24
"23UBGJ","Swindon Village",6008,2999,3009,6008,0,45
"23UBGK","Up Hatherley",5587,2712,2875,5587,0,98
"23UBGL","Warden Hill",5605,2703,2902,5587,18,58
"23UCGL","Ampney-Coln",1811,891,920,1781,30,75
"23UCGM","Avening",1865,922,943,1834,31,43
"23UCGN","Beacon-Stow",3470,1632,1838,3392,78,54
"23UCGP","Blockley",1997,975,1022,1996,3,32
"23UCGQ","Bourton-on-the-Water",3442,1644,1798,3385,57,46
"23UCGR","Campden-Vale",5705,2719,2986,5647,58,113
"23UCGS","Chedworth",1655,815,840,1625,30,62
"23UCGT","Churn Valley",1966,986,980,1708,258,51
"23UCGU","Cirencester Beeches",4030,2018,2012,4030,0,44
"23UCGW","Cirencester Chesterton",4013,1964,2049,3924,89,42
"23UCGX","Cirencester Park",2972,1341,1631,2722,250,33
"23UCGY","Cirencester Stratton-Whiteway",3457,1720,1737,3453,4,73
"23UCGZ","Cirencester Watermoor",3852,1877,1975,3805,47,33
"23UCHA","Ermin",1730,846,884,1720,10,76
"23UCHB","Fairford",3998,1938,2060,3925,73,105
"23UCHC","Fosseridge",1852,870,982,1852,0,43
"23UCHD","Grumbolds Ash",2013,941,1072,1903,110,60
"23UCHE","Hampton",1647,809,838,1647,0,52
"23UCHF","Kempsford-Lechlade",4050,1996,2054,4048,3,83
"23UCHG","Moreton-in-Marsh",3198,1487,1711,3155,43,29
"23UCHH","Northleach",1923,908,1015,1848,75,28
"23UCHJ","Rissingtons",1913,943,970,1909,4,42
"23UCHK","Riversmeet",1887,933,954,1884,3,70
"23UCHL","Sandywell",1797,881,916,1790,7,48
"23UCHM","Tetbury",5250,2582,2668,5176,74,60
"23UCHN","Thames Head",1865,934,931,1862,3,47
"23UCHP","Three Rivers",1898,919,979,1856,42,59
"23UCHQ","Water Park",5120,2572,2548,5007,113,101
"23UDGF","Alvington, Aylburton and West Lydney",3022,1487,1535,2997,25,42
"23UDGG","Awre",1644,803,841,1613,31,20
"23UDGH","Berry Hill",1640,790,850,1640,0,17
"23UDGJ","Blaisdon and Longhope",1710,854,856,1659,51,25
"23UDGK","Bream",3124,1517,1607,3119,5,22
"23UDGL","Bromesberrow and Dymock",1840,895,945,1810,30,55
"23UDGM","Christchurch and English Bicknor",1517,745,772,1482,35,38
"23UDGN","Churcham and Huntley",1692,851,841,1658,34,24
"23UDGP","Cinderford East",3607,1757,1850,3605,3,19
"23UDGQ","Cinderford West",4509,2215,2294,4493,16,15
"23UDGR","Coleford Central",3055,1431,1624,3018,37,25
"23UDGS","Coleford East",5296,2594,2702,5290,6,46
"23UDGT","Hartpury",2148,914,1234,1617,531,27
"23UDGU","Hewelsfield and Woolaston",1702,850,852,1702,0,38
"23UDGW","Littledean and Ruspidge",3601,1763,1838,3588,13,26
"23UDGX","Lydbrook and Ruardean",4876,2436,2440,4849,27,37
"23UDGY","Lydney East",5245,2568,2677,5175,70,26
"23UDGZ","Lydney North",1866,922,944,1866,0,18
"23UDHA","Mitcheldean and Drybrook",4238,2019,2219,4119,119,32
"23UDHB","Newent Central",3675,1746,1929,3638,37,34
"23UDHC","Newland and St Briavels",3342,1664,1678,3315,27,48
"23UDHD","Newnham and Westbury",3076,1515,1561,2948,128,42
"23UDHE","Oxenhall and Newent North East",1508,724,784,1504,4,23
"23UDHF","Pillowell",3347,1646,1701,3347,0,37
"23UDHG","Redmarley",1738,874,864,1738,0,33
"23UDHH","Tibberton",1648,822,826,1648,0,44
"23UDHJ","Tidenham",5316,2608,2708,5048,268,80
"23UEFR","Abbey",9556,4729,4827,9528,28,128
"23UEFS","Barnwood",9115,4469,4646,9064,51,92
"23UEFT","Barton and Tredworth",10327,5173,5154,10251,76,58
"23UEFU","Elmbridge",5617,2662,2955,5492,125,77
"23UEFW","Grange",5768,2835,2933,5764,4,39
"23UEFX","Hucclecote",9159,4422,4737,9147,12,86
"23UEFY","Kingsholm and Wotton",6263,3041,3222,5675,588,75
"23UEFZ","Longlevens",9063,4470,4593,9058,5,106
"23UEGA","Matson and Robinswood",10242,4958,5284,10168,74,44
"23UEGB","Moreland",10054,4977,5077,9896,158,65
"23UEGC","Podsmead",3116,1507,1609,3067,49,27
"23UEGD","Quedgeley Fieldcourt",5510,2693,2817,5479,31,34
"23UEGE","Quedgeley Severn Vale",6290,3096,3194,6237,53,26
"23UEGF","Tuffley",5749,2771,2978,5631,118,53
"23UEGG","Westgate",4056,2200,1856,3863,193,37
"23UFGJ","Amberley and Woodchester",2108,1025,1083,2087,21,62
"23UFGK","Berkeley",4091,2031,2060,4035,56,40
"23UFGL","Bisley",2107,1042,1065,2107,0,61
"23UFGM","Cainscross",6667,3268,3399,6548,119,68
"23UFGN","Cam East",4061,1975,2086,4061,0,68
"23UFGP","Cam West",4219,2058,2161,4219,0,45
"23UFGQ","Central",1685,837,848,1625,60,17
"23UFGR","Chalford",6276,3103,3173,6262,14,110
"23UFGS","Coaley and Uley",2324,1171,1153,2312,12,66
"23UFGT","Dursley",5814,2830,2984,5739,75,66
"23UFGU","Eastington and Standish",1895,926,969,1673,222,21
"23UFGW","Farmhill and Paganhill",2215,1087,1128,2189,26,26
"23UFGX","Hardwicke",4593,2278,2315,4590,3,49
"23UFGY","Kingswood",2025,999,1026,1917,108,43
"23UFGZ","Minchinhampton",3937,1891,2046,3814,123,93
"23UFHA","Nailsworth",6075,3013,3062,5954,121,110
"23UFHB","Over Stroud",1771,850,921,1771,0,35
"23UFHC","Painswick",4114,1922,2192,4057,57,104
"23UFHD","Rodborough",4357,2150,2207,4350,7,74
"23UFHE","Severn",4430,2221,2209,4339,91,75
"23UFHF","Slade",2262,1132,1130,2251,11,15
"23UFHG","Stonehouse",7603,3747,3856,7239,364,60
"23UFHH","The Stanleys",4235,2074,2161,4145,90,90
"23UFHJ","Thrupp",2272,1121,1151,2272,0,45
"23UFHK","Trinity",2203,1038,1165,2147,56,20
"23UFHL","Uplands",2163,1051,1112,2132,31,24
"23UFHM","Upton St Leonards",2116,1036,1080,2057,59,45
"23UFHN","Vale",1764,866,898,1727,37,18
"23UFHP","Valley",2162,1073,1089,2141,21,15
"23UFHQ","Wotton-under-Edge",6354,3093,3261,6265,89,104
"23UGGE","Ashchurch with Walton Cardiff",2255,1140,1115,2205,50,28
"23UGGF","Badgeworth",2205,1092,1113,2129,76,25
"23UGGG","Brockworth",6404,3047,3357,6305,99,49
"23UGGH","Churchdown Brookfield",4138,1973,2165,4111,27,104
"23UGGJ","Churchdown St John's",6634,3187,3447,6634,0,67
"23UGGK","Cleeve Grange",1944,952,992,1944,0,27
"23UGGL","Cleeve Hill",3460,1664,1796,3399,61,100
"23UGGM","Cleeve St Michael's",3735,1754,1981,3735,0,33
"23UGGN","Cleeve West",4265,2047,2218,4220,45,44
"23UGGP","Coombe Hill",4560,2243,2317,4534,26,62
"23UGGQ","Highnam with Haw Bridge",4343,2136,2207,4250,93,128
"23UGGR","Hucclecote",1514,712,802,1436,78,14
"23UGGS","Innsworth with Down Hatherley",2677,1316,1361,2572,105,64
"23UGGT","Isbourne",2007,984,1023,2000,7,51
"23UGGU","Northway",4902,2468,2434,4828,74,28
"23UGGW","Oxenton Hill",1517,738,779,1517,0,23
"23UGGX","Shurdington",1912,902,1010,1876,36,20
"23UGGY","Tewkesbury Newtown",1999,1003,996,1999,0,31
"23UGGZ","Tewkesbury Prior's Park",4171,2098,2073,4165,6,21
"23UGHA","Tewkesbury Town with Mitton",3917,1869,2048,3883,34,50
"23UGHB","Twyning",1696,839,857,1672,24,35
"23UGHC","Winchcombe",6150,2986,3164,6134,16,88
"24UBHP","Basing",8191,4011,4180,8061,130,161
"24UBHQ","Baughurst",2473,1239,1234,2473,0,70
"24UBHR","Brighton Hill North",5123,2598,2525,5123,0,29
"24UBHS","Brighton Hill South",5763,2772,2991,5763,0,27
"24UBHT","Brookvale and Kings Furlong",4820,2372,2448,4788,32,23
"24UBHU","Buckskin",5326,2614,2712,5289,37,14
"24UBHW","Burghclere",2813,1416,1397,2749,64,70
"24UBHX","Calleva",5812,2808,3004,5638,174,128
"24UBHY","Chineham",7003,3562,3441,7003,0,78
"24UBHZ","East Woodhay",2794,1354,1440,2742,52,108
"24UBJA","Eastrop",4270,2121,2149,4228,42,28
"24UBJB","Grove",5814,2925,2889,5774,40,76
"24UBJC","Hatch Warren and Beggarwood",7802,4071,3731,7802,0,87
"24UBJD","Highclere and Bourne",2939,1475,1464,2933,6,100
"24UBJE","Kempshott",7241,3632,3609,7241,0,121
"24UBJF","Kingsclere",4944,2458,2486,4829,115,116
"24UBJG","Norden",8166,3966,4200,8023,143,35
"24UBJH","Oakley and North Waltham",6924,3448,3476,6893,31,157
"24UBJJ","Overton, Laverstoke and Steventon",4602,2265,2337,4543,59,96
"24UBJK","Pamber",2631,1341,1290,2624,7,47
"24UBJL","Popley East",5410,2622,2788,5410,0,20
"24UBJM","Popley West",3750,1868,1882,3732,18,9
"24UBJN","Rooksdown",1216,556,660,1171,45,3
"24UBJP","Sherborne St John",3010,1488,1522,2967,43,79
"24UBJQ","South Ham",7449,3590,3859,7436,13,31
"24UBJR","Tadley North",6274,3138,3136,6244,30,70
"24UBJS","Tadley South",5377,2749,2628,5344,33,65
"24UBJT","Upton Grey and The Candovers",2733,1315,1418,2716,17,111
"24UBJU","Whitchurch",4814,2321,2493,4749,65,71
"24UBJW","Winklebury",7089,3461,3628,6984,105,41
"24UCGJ","Alton Amery",2434,1174,1260,2428,6,37
"24UCGK","Alton Ashdell",2200,1102,1098,2200,0,37
"24UCGL","Alton Eastbrooke",2686,1263,1423,2610,76,19
"24UCGM","Alton Westbrooke",2554,1204,1350,2544,10,15
"24UCGN","Alton Whitedown",2254,1067,1187,2225,29,54
"24UCGP","Alton Wooteys",2381,1178,1203,2328,53,28
"24UCGQ","Binsted and Bentley",2654,1263,1391,2594,60,69
"24UCGR","Bramshott and Liphook",7904,3846,4058,7842,62,156
"24UCGS","Clanfield and Finchdean",4725,2358,2367,4725,0,63
"24UCGT","Downland",2149,1062,1087,2139,10,96
"24UCGU","East Meon",2133,1064,1069,2080,53,57
"24UCGW","Four Marks and Medstead",5430,2683,2747,5373,57,141
"24UCGX","Froxfield and Steep",2725,1304,1421,2340,385,91
"24UCGY","Grayshott",2305,1097,1208,2224,81,51
"24UCGZ","Headley",5459,2676,2783,5416,43,126
"24UCHA","Holybourne and Froyle",2897,1433,1464,2573,324,82
"24UCHB","Horndean Catherington and Lovedean",2332,1174,1158,2332,0,22
"24UCHC","Horndean Downs",2532,1237,1295,2532,0,24
"24UCHD","Horndean Hazleton and Blendworth",2326,1130,1196,2223,103,26
"24UCHE","Horndean Kings",3029,1437,1592,3029,0,27
"24UCHF","Horndean Murray",2420,1196,1224,2420,0,34
"24UCHG","Lindford",2268,1153,1115,2238,30,28
"24UCHH","Liss",4904,2306,2598,4561,343,117
"24UCHJ","Petersfield Bell Hill",2352,1151,1201,2306,46,36
"24UCHK","Petersfield Causeway",2436,1152,1284,2430,6,13
"24UCHL","Petersfield Heath",2212,1126,1086,2212,0,46
"24UCHM","Petersfield Rother",2204,1053,1151,2204,0,61
"24UCHN","Petersfield St Marys",1927,900,1027,1844,83,56
"24UCHP","Petersfield St Peters",2172,999,1173,2170,3,28
"24UCHQ","Ropley and Tisted",2115,1017,1098,2115,0,71
"24UCHR","Rowlands Castle",2552,1235,1317,2527,25,56
"24UCHS","Selborne",2214,1148,1066,2151,63,48
"24UCHT","The Hangers and Forest",2439,1181,1258,2341,98,51
"24UCHU","Whitehill Chase",2374,1158,1216,2340,34,14
"24UCHW","Whitehill Deadwater",2873,1456,1417,2871,3,23
"24UCHX","Whitehill Hogmoor",3149,1904,1245,2402,747,17
"24UCHY","Whitehill Pinewood",3209,1668,1541,3095,114,21
"24UCHZ","Whitehill Walldown",2345,1178,1167,2340,5,14
"24UDFT","Bishopstoke East",5671,2868,2803,5671,0,39
"24UDFU","Bishopstoke West",5437,2658,2779,5406,31,37
"24UDFW","Botley",5155,2521,2634,5131,24,65
"24UDFX","Bursledon and Old Netley",7445,3578,3867,7393,52,61
"24UDFY","Chandler's Ford East",4851,2363,2488,4810,41,54
"24UDFZ","Chandler's Ford West",5296,2578,2718,5245,51,57
"24UDGA","Eastleigh Central",8337,4157,4180,8331,6,30
"24UDGB","Eastleigh North",7914,3916,3998,7913,3,88
"24UDGC","Eastleigh South",7839,3742,4097,7810,29,34
"24UDGD","Fair Oak and Horton Heath",8579,4302,4277,8544,35,74
"24UDGE","Hamble-le-Rice and Butlocks Heath",5169,2552,2617,5155,14,31
"24UDGF","Hedge End Grange Park",5800,2878,2922,5796,4,22
"24UDGG","Hedge End St John's",7462,3703,3759,7365,97,58
"24UDGH","Hedge End Wildern",5434,2654,2780,5358,76,24
"24UDGJ","Hiltingbury East",4965,2438,2527,4910,55,124
"24UDGK","Hiltingbury West",4959,2440,2519,4882,77,122
"24UDGL","Netley Abbey",5128,2451,2677,5044,84,19
"24UDGM","West End North",5035,2419,2616,4881,154,29
"24UDGN","West End South",5693,2782,2911,5656,37,45
"24UEFQ","Fareham East",6893,3319,3574,6775,118,82
"24UEFR","Fareham North",6866,3337,3529,6714,152,96
"24UEFS","Fareham North-West",7343,3531,3812,7308,35,57
"24UEFT","Fareham South",6786,3314,3472,6786,0,19
"24UEFU","Fareham West",6749,3287,3462,6691,58,65
"24UEFW","Hill Head",7121,3331,3790,7040,81,159
"24UEFX","Locks Heath",7035,3364,3671,6977,58,99
"24UEFY","Park Gate",6871,3366,3505,6722,149,53
"24UEFZ","Portchester East",10738,5160,5578,10724,14,68
"24UEGA","Portchester West",6899,3452,3447,6802,97,59
"24UEGB","Sarisbury",6400,3212,3188,6337,63,79
"24UEGC","Stubbington",7805,4094,3711,6725,1080,107
"24UEGD","Titchfield",6974,3420,3554,6769,205,108
"24UEGE","Titchfield Common",6757,3354,3403,6724,33,60
"24UEGF","Warsash",6740,3341,3399,6606,134,99
"24UFFL","Alverstoke",4175,2008,2167,3975,200,89
"24UFFM","Anglesey",4204,1998,2206,3414,790,101
"24UFFN","Bridgemary North",4813,2319,2494,4807,6,30
"24UFFP","Bridgemary South",4825,2358,2467,4821,4,21
"24UFFQ","Brockhurst",5949,3330,2619,4870,1079,23
"24UFFR","Christchurch",3838,1857,1981,3811,27,18
"24UFFS","Elson",4814,2380,2434,4814,0,23
"24UFFT","Forton",4553,2249,2304,4553,0,19
"24UFFU","Grange",6006,2867,3139,6006,0,27
"24UFFW","Hardway",4135,2045,2090,4117,18,27
"24UFFX","Lee East",3080,1472,1608,3080,0,36
"24UFFY","Lee West",3987,1824,2163,3835,152,42
"24UFFZ","Leesland",4529,2205,2324,4459,70,21
"24UFGA","Peel Common",4182,2010,2172,4182,0,31
"24UFGB","Privett",4128,2017,2111,4107,21,41
"24UFGC","Rowner and Holbrook",4915,2443,2472,4912,3,37
"24UFGD","Town",4282,1957,2325,4249,33,10
"24UGFS","Blackwater and Hawley",4761,2683,2078,4147,614,64
"24UGFT","Church Crookham East",4711,2326,2385,4633,78,84
"24UGFU","Church Crookham West",4999,2533,2466,4990,9,71
"24UGFW","Crondall",4053,1983,2070,3972,81,122
"24UGFX","Eversley",2598,1308,1290,2559,39,58
"24UGFY","Fleet Central",4949,2449,2500,4939,10,91
"24UGFZ","Fleet Courtmoor",4634,2327,2307,4634,0,128
"24UGGA","Fleet North",3088,1595,1493,3088,0,34
"24UGGB","Fleet Pondtail",4621,2278,2343,4540,81,98
"24UGGC","Fleet West",4777,2320,2457,4633,144,115
"24UGGD","Frogmore and Darby Green",5616,2829,2787,5616,0,63
"24UGGE","Hartley Wintney",4843,2355,2488,4834,9,116
"24UGGF","Hook",7378,3681,3697,7268,110,159
"24UGGG","Long Sutton",2910,1683,1227,2264,646,64
"24UGGH","Odiham",4172,2007,2165,4108,64,98
"24UGGJ","Yateley East",5168,2581,2587,5161,7,79
"24UGGK","Yateley North",5078,2506,2572,5078,0,67
"24UGGL","Yateley West",5149,2615,2534,5149,0,124
"24UHFQ","Barncroft",6073,2949,3124,6015,58,17
"24UHFR","Battins",6594,3118,3476,6578,16,18
"24UHFS","Bedhampton",8597,4108,4489,8469,128,66
"24UHFT","Bondfields",6931,3380,3551,6931,0,14
"24UHFU","Cowplain",9215,4503,4712,9171,44,79
"24UHFW","Emsworth",9373,4379,4994,9173,200,143
"24UHFX","Hart Plain",9462,4638,4824,9462,0,44
"24UHFY","Hayling East",8647,4152,4495,8414,233,59
"24UHFZ","Hayling West",8240,3854,4386,7999,241,94
"24UHGA","Purbrook",9152,4520,4632,9097,55,66
"24UHGB","St Faith's",8415,4004,4411,8336,79,145
"24UHGC","Stakes",10065,4854,5211,10036,29,54
"24UHGD","Warren Park",6951,3301,3650,6951,0,22
"24UHGE","Waterloo",9134,4351,4783,9015,119,104
"24UJGL","Ashurst, Copythorne South and Netley Marsh",5535,2688,2847,5339,196,81
"24UJGM","Barton",5056,2324,2732,4950,106,50
"24UJGN","Bashley",2740,1315,1425,2708,32,31
"24UJGP","Becton",4751,2193,2558,4571,180,53
"24UJGQ","Boldre and Sway",5242,2521,2721,5046,196,132
"24UJGR","Bramshaw, Copythorne North and Minstead",2464,1218,1246,2404,60,52
"24UJGS","Bransgore and Burley",5683,2702,2981,5601,82,141
"24UJGT","Brockenhurst and Forest South East",5410,2612,2798,5241,169,148
"24UJGU","Buckland",3172,1530,1642,3172,0,42
"24UJGW","Butts Ash and Dibden Purlieu",6457,3117,3340,6396,61,91
"24UJGX","Dibden and Hythe East",5502,2641,2861,5497,5,70
"24UJGY","Downlands and Forest",2899,1415,1484,2899,0,73
"24UJGZ","Fawley, Blackfield and Langley",6088,3031,3057,6049,39,55
"24UJHA","Fernhill",5746,2713,3033,5691,55,41
"24UJHB","Fordingbridge",6357,3051,3306,6158,199,104
"24UJHC","Forest North West",2665,1280,1385,2510,155,60
"24UJHD","Furzedown and Hardley",3207,1585,1622,3199,8,31
"24UJHE","Holbury and North Blackfield",6995,3379,3616,6995,0,45
"24UJHF","Hordle",5095,2380,2715,5071,24,37
"24UJHG","Hythe West and Langdown",6026,2862,3164,6026,0,66
"24UJHH","Lymington Town",5293,2382,2911,5140,153,75
"24UJHJ","Lyndhurst",2973,1401,1572,2855,118,42
"24UJHK","Marchwood",5586,2845,2741,5316,270,65
"24UJHL","Milford",4703,2162,2541,4564,139,93
"24UJHM","Milton",5460,2393,3067,5282,178,35
"24UJHN","Pennington",5864,2697,3167,5834,30,60
"24UJHP","Ringwood East and Sopley",2798,1395,1403,2698,100,47
"24UJHQ","Ringwood North",5973,2878,3095,5927,46,72
"24UJHR","Ringwood South",5605,2627,2978,5542,63,44
"24UJHS","Totton Central",5330,2605,2725,5295,35,49
"24UJHT","Totton East",5708,2780,2928,5695,13,29
"24UJHU","Totton North",5832,2835,2997,5720,112,33
"24UJHW","Totton South",6009,2944,3065,6009,0,33
"24UJHX","Totton West",5107,2516,2591,5087,20,22
"24ULFR","Cove and Southwood",6548,3337,3211,6543,5,55
"24ULFS","Empress",6393,3228,3165,6372,21,95
"24ULFT","Fernhill",6033,3001,3032,5905,128,52
"24ULFU","Grange",6085,2944,3141,6085,0,51
"24ULFW","Heron Wood",6161,2983,3178,6117,44,17
"24ULFX","Knellwood",5964,2927,3037,5819,145,105
"24ULFY","Manor Park",6285,3069,3216,6207,78,52
"24ULFZ","Mayfield",6736,3270,3466,6736,0,23
"24ULGA","North Town",7074,3512,3562,7067,7,28
"24ULGB","Rowhill",5920,2944,2976,5816,104,38
"24ULGC","St. John's",6565,3331,3234,6542,23,77
"24ULGD","St. Mark's",6939,3601,3338,6618,321,81
"24ULGE","Wellington",8400,4780,3620,6837,1563,71
"24ULGF","Westheath",5884,2955,2929,5884,0,58
"24UNGA","Abbey",4157,1871,2286,4100,57,40
"24UNGB","Alamein",7989,3940,4049,7870,119,31
"24UNGC","Ampfield and Braishfield",2117,1053,1064,2108,9,50
"24UNGD","Amport",2155,1077,1078,2087,68,59
"24UNGE","Anna",3645,1840,1805,3509,136,133
"24UNGF","Blackwater",5086,2535,2551,4793,293,114
"24UNGG","Bourne Valley",2064,1009,1055,2058,6,65
"24UNGH","Broughton and Stockbridge",4495,2159,2336,4403,92,140
"24UNGJ","Charlton",2051,1015,1036,2039,12,28
"24UNGK","Chilworth, Nursling and Rownhams",6382,3158,3224,6306,76,127
"24UNGL","Cupernham",5108,2480,2628,5038,70,60
"24UNGM","Dun Valley",2162,1043,1119,2129,33,42
"24UNGN","Harewood",2160,1067,1093,2160,0,90
"24UNGP","Harroway",7155,3508,3647,7123,32,62
"24UNGQ","Kings Somborne and Michelmersh",2434,1242,1192,2434,0,62
"24UNGR","Millway",6998,3398,3600,6796,202,121
"24UNGS","North Baddesley",6234,3012,3222,6226,8,55
"24UNGT","Over Wallop",1682,934,748,1466,216,54
"24UNGU","Penton Bellinger",4459,2187,2272,4459,0,102
"24UNGW","Romsey Extra",3327,1627,1700,3265,62,71
"24UNGX","St Mary's",7587,3689,3898,7506,81,42
"24UNGY","Tadburn",5382,2674,2708,5382,0,66
"24UNGZ","Valley Park",7484,3724,3760,7484,0,92
"24UNHA","Winton",7488,3666,3822,7452,36,91
"24UPGK","Bishops Waltham",6550,3147,3403,6466,84,76
"24UPGL","Boarhunt and Southwick",1911,1180,731,1255,656,17
"24UPGM","Cheriton and Bishops Sutton",2138,1071,1067,2051,87,64
"24UPGN","Colden Common and Twyford",5137,2552,2585,5098,39,93
"24UPGP","Compton and Otterbourne",3724,1815,1909,3604,120,157
"24UPGQ","Denmead",6190,3027,3163,6119,71,87
"24UPGR","Droxford, Soberton and Hambledon",1914,924,990,1894,20,61
"24UPGS","Itchen Valley",1811,892,919,1794,17,84
"24UPGT","Kings Worthy",4044,1971,2073,3866,178,84
"24UPGU","Littleton and Harestock",3802,1929,1873,3467,335,71
"24UPGW","Olivers Battery and Badger Farm",4028,1941,2087,4028,0,94
"24UPGX","Owslebury and Curdridge",3554,1741,1813,3439,115,98
"24UPGY","St Barnabas",5513,2640,2873,5419,94,127
"24UPGZ","St Bartholomew",5477,2425,3052,5042,435,73
"24UPHA","St John and All Saints",6030,2762,3268,5788,242,67
"24UPHB","St Luke",5588,2586,3002,5575,13,44
"24UPHC","St Michael",6003,3203,2800,4736,1267,140
"24UPHD","St Paul",6133,3063,3070,4691,1442,118
"24UPHE","Shedfield",3914,1931,1983,3845,69,48
"24UPHF","Sparsholt",1791,926,865,1458,333,55
"24UPHG","Swanmore and Newtown",4044,1975,2069,4044,0,105
"24UPHH","The Alresfords",6020,2967,3053,5965,55,144
"24UPHJ","Upper Meon Valley",1814,895,919,1811,3,71
"24UPHK","Whiteley",2195,1134,1061,2195,0,13
"24UPHL","Wickham",2621,1299,1322,2521,100,42
"24UPHM","Wonston and Micheldever",5276,2560,2716,5246,30,161
"26UBFQ","Broxbourne",6123,2991,3132,6087,36,93
"26UBFR","Bury Green",6202,2948,3254,6179,23,37
"26UBFS","Cheshunt Central",7172,3496,3676,7172,0,48
"26UBFT","Cheshunt North",7444,3599,3845,7444,0,35
"26UBFU","Flamstead End",6549,3185,3364,6549,0,68
"26UBFW","Goffs Oak",7765,3782,3983,7765,0,87
"26UBFX","Hoddesdon North",6611,3320,3291,6556,55,65
"26UBFY","Hoddesdon Town",6276,3073,3203,6231,45,54
"26UBFZ","Rosedale",4465,2131,2334,4416,49,19
"26UBGA","Rye Park",7130,3489,3641,7119,11,39
"26UBGB","Theobalds",6679,3231,3448,6668,11,40
"26UBGC","Waltham Cross",6492,3132,3360,6492,0,22
"26UBGD","Wormley & Turnford",8146,3897,4249,8068,78,46
"26UCGF","Adeyfield East",5491,2637,2854,5445,46,48
"26UCGG","Adeyfield West",4930,2386,2544,4930,0,28
"26UCGH","Aldbury and Wigginton",2364,1162,1202,2333,31,48
"26UCGJ","Apsley",2916,1494,1422,2879,37,23
"26UCGK","Ashridge",2650,1326,1324,2605,45,92
"26UCGL","Bennetts End",5899,2841,3058,5862,37,24
"26UCGM","Berkhamsted Castle",5660,2792,2868,5639,21,102
"26UCGN","Berkhamsted East",5388,2613,2775,5302,86,114
"26UCGP","Berkhamsted West",5450,2598,2852,5390,60,132
"26UCGQ","Bovingdon, Flaunden & Chipperfield",8819,4715,4104,8066,753,169
"26UCGR","Boxmoor",5495,2657,2838,5479,16,104
"26UCGS","Chaulden & Shrubhill",5135,2526,2609,5135,0,65
"26UCGT","Corner Hall",5935,2933,3002,5875,60,46
"26UCGU","Gadebridge",5241,2602,2639,5181,60,29
"26UCGW","Grove Hill",7796,3830,3966,7780,16,43
"26UCGX","Hemel Hempstead Central",4865,2383,2482,4551,314,51
"26UCGY","Highfield & St Pauls",7269,3530,3739,7190,79,38
"26UCGZ","Kings Langley",5072,2475,2597,5038,34,68
"26UCHA","Leverstock Green",7010,3461,3549,6990,20,79
"26UCHB","Nash Mills",2658,1315,1343,2646,12,35
"26UCHC","Northchurch",2661,1282,1379,2661,0,26
"26UCHD","Tring Central",5117,2524,2593,5109,8,41
"26UCHE","Tring East",2738,1326,1412,2738,0,77
"26UCHF","Tring West",5464,2612,2852,5250,214,72
"26UCHG","Warners End",4842,2345,2497,4842,0,49
"26UCHH","Watling",5273,2644,2629,5211,62,63
"26UCHJ","Woodhall",5661,2788,2873,5661,0,51
"26UDGH","Bishop's Stortford All Saints",7204,3523,3681,6900,304,162
"26UDGJ","Bishop's Stortford Central",8946,4316,4630,8919,27,94
"26UDGK","Bishop's Stortford Meads",5044,2410,2634,5034,10,99
"26UDGL","Bishop's Stortford Silverleys",5561,2785,2776,5356,205,109
"26UDGM","Bishop's Stortford South",8570,4282,4288,8529,41,135
"26UDGN","Braughing",2459,1208,1251,2459,0,53
"26UDGP","Buntingford",5245,2563,2682,5210,35,71
"26UDGQ","Datchworth & Aston",2324,1154,1170,2323,0,55
"26UDGR","Great Amwell",2803,1333,1470,2803,0,21
"26UDGS","Hertford Bengeo",7118,3440,3678,6977,141,119
"26UDGT","Hertford Castle",7164,3512,3652,6814,350,116
"26UDGU","Hertford Heath",3013,1602,1411,2656,357,38
"26UDGW","Hertford Kingsmead",5225,2556,2669,5193,32,44
"26UDGX","Hertford Rural North",2241,1127,1114,2241,0,58
"26UDGY","Hertford Rural South",2323,1136,1187,2323,0,62
"26UDGZ","Hertford Sele",5343,2585,2758,5331,12,40
"26UDHA","Hunsdon",2636,1317,1319,2602,34,36
"26UDHB","Little Hadham",2218,1103,1115,2218,0,55
"26UDHC","Mundens and Cottered",2358,1181,1177,2323,35,43
"26UDHD","Much Hadham",2784,1274,1510,2579,205,42
"26UDHE","Puckeridge",2535,1261,1274,2535,0,17
"26UDHF","Sawbridgeworth",8007,3894,4113,7956,51,125
"26UDHG","Stanstead Abbots",2737,1317,1420,2579,158,24
"26UDHH","Thundridge & Standon",2927,1488,1439,2760,167,49
"26UDHJ","Walkern",2669,1306,1363,2669,0,44
"26UDHK","Ware Chadwell",2328,1124,1204,2299,29,29
"26UDHL","Ware Christchurch",4701,2251,2450,4554,147,37
"26UDHM","Ware St Mary's",5243,2596,2647,5237,6,70
"26UDHN","Ware Trinity",4921,2435,2486,4911,10,47
"26UDHP","Watton-at-Stone",2272,1142,1130,2267,5,45
"26UEFX","Aldenham East",4823,2413,2410,4810,13,136
"26UEFY","Aldenham West",5119,2548,2571,4578,541,116
"26UEFZ","Borehamwood Brookmeadow",6931,3337,3594,6920,11,52
"26UEGA","Borehamwood Cowley Hill",7994,3751,4243,7898,96,36
"26UEGB","Borehamwood Hillside",8076,3928,4148,7945,131,50
"26UEGC","Borehamwood Kenilworth",5545,2714,2831,5507,38,25
"26UEGD","Bushey Heath",6476,3054,3422,6321,155,223
"26UEGE","Bushey North",6218,3053,3165,5910,308,66
"26UEGF","Bushey Park",4588,2168,2420,4530,58,57
"26UEGG","Bushey St James",7323,3488,3835,7259,64,140
"26UEGH","Elstree",4765,2330,2435,4641,124,125
"26UEGJ","Potters Bar Furzefield",6495,3154,3341,6488,7,72
"26UEGK","Potters Bar Oakmere",7333,3464,3869,7190,143,54
"26UEGL","Potters Bar Parkfield",7117,3444,3673,6957,160,122
"26UEGM","Shenley",5647,2722,2925,5469,178,62
"26UFGC","Arbury",2462,1196,1266,2460,3,71
"26UFGD","Baldock East",2435,1232,1203,2435,0,17
"26UFGE","Baldock Town",7431,3631,3800,7199,232,74
"26UFGF","Cadwell",2240,1110,1130,2240,0,35
"26UFGG","Codicote",2560,1239,1321,2560,0,49
"26UFGH","Ermine",2432,1182,1250,2398,34,45
"26UFGJ","Graveley & Wymondley",2841,1381,1460,2739,102,23
"26UFGK","Hitchin Bearton",7000,3566,3434,7000,0,87
"26UFGL","Hitchin Highbury",6950,3363,3587,6868,82,124
"26UFGM","Hitchin Oughton",4952,2350,2602,4928,24,29
"26UFGN","Hitchin Priory",4774,2259,2515,4653,121,109
"26UFGP","Hitchin Walsworth",7175,3559,3616,7175,0,64
"26UFGQ","Hitchwood",2517,1188,1329,2389,128,41
"26UFGR","Hoo",2397,1119,1278,2303,94,28
"26UFGS","Kimpton",2113,1054,1059,2113,0,66
"26UFGT","Knebworth",5034,2440,2594,4896,138,92
"26UFGU","Letchworth East",6910,3320,3590,6822,88,86
"26UFGW","Letchworth Grange",6472,3128,3344,6444,28,47
"26UFGX","Letchworth South East",6754,3279,3475,6664,90,120
"26UFGY","Letchworth South West",7363,3573,3790,7117,246,186
"26UFGZ","Letchworth Wilbury",5433,2622,2811,5433,0,43
"26UFHA","Offa",2073,1020,1053,2003,70,27
"26UFHB","Royston Heath",4873,2396,2477,4850,23,98
"26UFHC","Royston Meridian",4616,2265,2351,4616,0,65
"26UFHD","Royston Palace",5081,2502,2579,5031,50,54
"26UFHE","Weston and Sandon",2020,993,1027,2020,0,41
"26UGFX","Ashley",7030,3567,3463,7021,9,87
"26UGFY","Batchwood",6728,3143,3585,6485,243,67
"26UGFZ","Clarence",6069,2968,3101,6024,45,157
"26UGGA","Colney Heath",5449,2732,2717,5344,105,69
"26UGGB","Cunningham",6040,2934,3106,6000,40,81
"26UGGC","Harpenden East",7033,3467,3566,6954,79,141
"26UGGD","Harpenden North",6860,3334,3526,6725,135,162
"26UGGE","Harpenden South",6612,3291,3321,6612,0,222
"26UGGF","Harpenden West",7181,3397,3784,6995,186,184
"26UGGG","London Colney",7742,3868,3874,7623,119,65
"26UGGH","Marshalswick North",6325,3122,3203,6325,0,121
"26UGGJ","Marshalswick South",6488,3112,3376,6468,20,171
"26UGGK","Park Street",6781,3383,3398,6624,157,77
"26UGGL","Redbourn",5904,2938,2966,5856,48,88
"26UGGM","St Peters",6503,3351,3152,6357,146,80
"26UGGN","St Stephen",6424,3178,3246,6292,132,90
"26UGGP","Sandridge",4808,2324,2484,4781,27,88
"26UGGQ","Sopwell",6784,3310,3474,6687,97,62
"26UGGR","Verulam",6186,3046,3140,6177,9,172
"26UGGS","Wheathampstead",6058,2949,3109,6049,9,108
"26UHFQ","Bandley Hill",6820,3354,3466,6702,118,42
"26UHFR","Bedwell",6544,3113,3431,6538,6,20
"26UHFS","Chells",6163,3023,3140,6163,0,27
"26UHFT","Longmeadow",5961,2911,3050,5943,18,50
"26UHFU","Manor",6396,3238,3158,6339,57,53
"26UHFW","Martins Wood",6283,3088,3195,6193,90,54
"26UHFX","Old Town",6185,3001,3184,6162,23,54
"26UHFY","Pin Green",5929,2940,2989,5911,18,40
"26UHFZ","Roebuck",6044,2979,3065,6029,15,28
"26UHGA","St Nicholas",6128,3070,3058,6117,11,38
"26UHGB","Shephall",6326,3121,3205,6311,15,30
"26UHGC","Symonds Green",5941,2977,2964,5922,19,49
"26UHGD","Woodfield",4995,2351,2644,4649,346,62
"26UJFX","Abbots Langley",4683,2230,2453,4630,53,54
"26UJFY","Ashridge",3675,1764,1911,3670,5,22
"26UJFZ","Bedmond & Primrose Hill",3243,1634,1609,3243,0,25
"26UJGA","Carpenders Park",4926,2408,2518,4894,32,58
"26UJGB","Chorleywood East",3895,1882,2013,3810,85,118
"26UJGC","Chorleywood West",5320,2543,2777,5290,30,142
"26UJGD","Croxley Green",5327,2589,2738,5327,0,77
"26UJGE","Croxley Green North",3384,1620,1764,3356,28,50
"26UJGF","Croxley Green South",3452,1718,1734,3448,4,42
"26UJGG","Hayling",3558,1669,1889,3558,0,16
"26UJGH","Langleybury",4853,2381,2472,4836,17,35
"26UJGJ","Leavesden",4499,2212,2287,4447,52,30
"26UJGK","Maple Cross & Mill End",5378,2659,2719,5361,17,38
"26UJGL","Moor Park & Eastbury",5451,2673,2778,5317,134,252
"26UJGM","Northwick",4759,2189,2570,4704,55,10
"26UJGN","Oxhey Hall",3332,1644,1688,3289,43,44
"26UJGP","Penn",3454,1677,1777,3448,6,13
"26UJGQ","Rickmansworth",4169,1903,2266,3804,365,66
"26UJGR","Rickmansworth West",3603,1735,1868,3505,98,91
"26UJGS","Sarratt",1887,932,955,1887,0,30
"26UKFN","Callowland",6653,3360,3293,6653,0,37
"26UKFP","Central",6577,3378,3199,6334,243,39
"26UKFQ","Holywell",7176,3518,3658,7059,117,41
"26UKFR","Leggatts",7044,3422,3622,6986,58,61
"26UKFS","Meriden",6865,3245,3620,6817,48,33
"26UKFT","Nascot",6532,3098,3434,6151,381,78
"26UKFU","Oxhey",6395,3043,3352,6354,41,79
"26UKFW","Park",6192,3040,3152,6105,87,156
"26UKFX","Stanborough",6852,3387,3465,6806,46,63
"26UKFY","Tudor",5591,2833,2758,5591,0,75
"26UKFZ","Vicarage",7149,3683,3466,6955,194,38
"26UKGA","Woodside",6700,3220,3480,6700,0,42
"26ULGJ","Brookmans Park and Little Heath",5937,2770,3167,5653,284,140
"26ULGK","Haldens",6076,3001,3075,6076,0,53
"26ULGL","Handside",6414,2980,3434,6365,49,99
"26ULGM","Hatfield Central",6270,3060,3210,6193,77,28
"26ULGN","Hatfield East",5997,2998,2999,5942,55,60
"26ULGP","Hatfield North",5851,2943,2908,5826,25,50
"26ULGQ","Hatfield South",4381,2196,2185,4381,0,15
"26ULGR","Hatfield West",7296,3607,3689,6162,1134,119
"26ULGS","Hollybush",5505,2576,2929,5451,54,23
"26ULGT","Howlands",6099,2937,3162,5960,139,39
"26ULGU","Northaw",5190,2545,2645,5166,24,85
"26ULGW","Panshanger",6433,3121,3312,6392,41,67
"26ULGX","Peartree",6985,3363,3622,6884,101,23
"26ULGY","Sherrards",5798,2824,2974,5768,30,88
"26ULGZ","Welham Green",3639,1754,1885,3499,140,22
"26ULHA","Welwyn North",4228,2059,2169,4158,70,67
"26ULHB","Welwyn South",5454,2629,2825,5413,41,123
"29UBGZ","Aylesford Green",2721,1270,1451,2721,0,7
"29UBHA","Beaver",5666,2758,2908,5639,27,6
"29UBHB","Biddenden",2434,1219,1215,2432,3,32
"29UBHC","Bockhanger",2468,1175,1293,2462,6,28
"29UBHD","Boughton Aluph and Eastwell",1954,963,991,1947,7,18
"29UBHE","Bybrook",2629,1244,1385,2613,16,21
"29UBHF","Charing",2284,1101,1183,2242,42,26
"29UBHG","Downs North",2378,1185,1193,2339,39,41
"29UBHH","Downs West",2463,1192,1271,2375,88,37
"29UBHJ","Godinton",3933,1910,2023,3933,0,23
"29UBHK","Great Chart with Singleton North",1753,857,896,1753,0,12
"29UBHL","Highfield",2551,1270,1281,2506,45,26
"29UBHM","Isle of Oxney",2499,1225,1274,2499,0,45
"29UBHN","Kennington",2321,1185,1136,2261,60,47
"29UBHP","Little Burton Farm",2125,1017,1108,2125,0,15
"29UBHQ","Norman",2658,1304,1354,2658,0,7
"29UBHR","North Willesborough",5125,2515,2610,4843,282,65
"29UBHS","Park Farm North",2766,1418,1348,2766,0,19
"29UBHT","Park Farm South",1124,558,566,1089,35,7
"29UBHU","Rolvenden and Tenterden West",2434,1154,1280,2410,24,54
"29UBHW","St Michaels",2437,1167,1270,2404,33,39
"29UBHX","Saxon Shore",4912,2423,2489,4861,51,97
"29UBHY","Singleton South",2453,1200,1253,2417,36,13
"29UBHZ","South Willesborough",2161,1064,1097,2161,0,6
"29UBJA","Stanhope",3276,1656,1620,3177,99,12
"29UBJB","Stour",5082,2425,2657,5041,41,58
"29UBJC","Tenterden North",2158,964,1194,2124,34,35
"29UBJD","Tenterden South",2272,1050,1222,2265,7,32
"29UBJE","Victoria",5240,2527,2713,5188,52,25
"29UBJF","Washford",2261,1114,1147,2256,5,3
"29UBJG","Weald Central",4605,2265,2340,4593,12,77
"29UBJH","Weald East",1902,941,961,1850,52,22
"29UBJJ","Weald North",2326,1137,1189,2326,0,52
"29UBJK","Weald South",4885,2389,2496,4856,29,71
"29UBJL","Wye",2405,1114,1291,2125,280,32
"29UCGC","Barham Downs",2551,1249,1302,2463,88,62
"29UCGD","Barton",9475,4561,4914,8701,774,120
"29UCGE","Blean Forest",4677,2236,2441,3220,1457,51
"29UCGF","Chartham and Stone Street",4941,2418,2523,4924,17,101
"29UCGG","Chestfield and Swalecliffe",7916,3771,4145,7894,22,79
"29UCGH","Gorrell",5883,2825,3058,5864,19,52
"29UCGJ","Greenhill and Eddington",5211,2540,2671,5168,43,40
"29UCGK","Harbledown",2593,1269,1324,2362,231,47
"29UCGL","Harbour",5698,2644,3054,5636,62,30
"29UCGM","Herne and Broomfield",7339,3600,3739,7242,97,74
"29UCGN","Heron",8478,3874,4604,8111,367,61
"29UCGP","Little Stour",2567,1236,1331,2493,74,41
"29UCGQ","Marshside",2685,1290,1395,2606,79,23
"29UCGR","North Nailbourne",2570,1198,1372,2485,85,47
"29UCGS","Northgate",5713,2629,3084,5507,206,28
"29UCGT","Reculver",7939,3681,4258,7688,251,76
"29UCGU","St Stephens",8996,4247,4749,8812,184,98
"29UCGW","Seasalter",6899,3255,3644,6844,55,39
"29UCGX","Sturry North",2782,1320,1462,2727,55,22
"29UCGY","Sturry South",2910,1379,1531,2831,79,37
"29UCGZ","Tankerton",4583,2082,2501,4343,240,48
"29UCHA","West Bay",6221,2965,3256,6134,87,25
"29UCHB","Westgate",8663,4086,4577,7793,870,88
"29UCHC","Wincheap",7988,3770,4218,7759,229,77
"29UDGA","Bean and Darenth",5672,2773,2899,5541,131,30
"29UDGB","Brent",6286,3070,3216,6133,153,53
"29UDGC","Castle",1316,669,647,1316,0,8
"29UDGD","Greenhithe",4202,2080,2122,4125,77,13
"29UDGE","Heath",6089,3026,3063,6059,30,89
"29UDGF","Joyce Green",3706,1730,1976,3706,0,7
"29UDGG","Joydens Wood",5599,2761,2838,5512,87,61
"29UDGH","Littlebrook",4288,2040,2248,4263,25,13
"29UDGJ","Longfield, New Barn and Southfleet",6168,3009,3159,6070,98,83
"29UDGK","Newtown",6608,3347,3261,6495,113,26
"29UDGL","Princes",6305,3042,3263,6008,297,29
"29UDGM","Stone",6252,3075,3177,6148,104,20
"29UDGN","Sutton-at-Hone and Hawley",4133,2041,2092,4098,35,41
"29UDGP","Swanscombe",6418,3147,3271,6418,0,14
"29UDGQ","Town",3750,1921,1829,3742,8,20
"29UDGR","West Hill",5292,2606,2686,5270,22,49
"29UDGS","Wilmington",3827,1784,2043,3684,143,37
"29UEGJ","Aylesham",4731,2254,2477,4699,32,22
"29UEGK","Buckland",7282,3466,3816,7269,13,34
"29UEGL","Capel-le-Ferne",2140,1047,1093,2118,22,17
"29UEGM","Castle",2011,950,1061,1938,73,27
"29UEGN","Eastry",4850,2353,2497,4691,159,61
"29UEGP","Eythorne and Shepherdswell",4571,2218,2353,4500,71,67
"29UEGQ","Little Stour and Ashstone",6244,3021,3223,6139,105,109
"29UEGR","Lydden and Temple Ewell",2380,1138,1242,2266,114,34
"29UEGS","Maxton, Elms Vale and Priory",7020,3448,3572,6862,158,39
"29UEGT","Middle Deal and Sholden",7236,3376,3860,7037,199,59
"29UEGU","Mill Hill",7614,3575,4039,7542,72,36
"29UEGW","North Deal",7225,3426,3799,7156,69,53
"29UEGX","Ringwould",1964,925,1039,1925,39,31
"29UEGY","River",4466,2144,2322,4320,146,57
"29UEGZ","St Margaret's-at-Cliffe",5169,2748,2421,4257,912,71
"29UEHA","St Radigunds",4868,2310,2558,4837,31,18
"29UEHB","Sandwich",6685,3172,3513,6577,108,90
"29UEHC","Tower Hamlets",4784,2305,2479,4768,16,20
"29UEHD","Town and Pier",2191,1160,1031,1914,277,8
"29UEHE","Walmer",6693,3158,3535,6508,185,87
"29UEHF","Whitfield",4442,2127,2315,4331,111,56
"29UGFW","Central",6286,3159,3127,6145,141,61
"29UGFX","Chalk",2214,1088,1126,2214,0,19
"29UGFY","Coldharbour",4794,2346,2448,4794,0,17
"29UGFZ","Higham",3938,1892,2046,3920,18,53
"29UGGA","Istead Rise",3505,1730,1775,3505,0,41
"29UGGB","Meopham North",4266,2090,2176,4241,25,71
"29UGGC","Meopham South and Vigo",4362,2192,2170,4362,0,57
"29UGGD","Northfleet North",6723,3317,3406,6656,67,30
"29UGGE","Northfleet South",6967,3395,3572,6967,0,42
"29UGGF","Painters Ash",6043,2972,3071,5896,147,37
"29UGGG","Pelham",6279,3142,3137,6138,141,66
"29UGGH","Riverside",6289,3032,3257,6289,0,38
"29UGGJ","Riverview",4608,2287,2321,4608,0,43
"29UGGK","Shorne, Cobham and Luddesdown",4139,2007,2132,4014,125,51
"29UGGL","Singlewell",7574,3685,3889,7541,33,30
"29UGGM","Westcourt",6915,3309,3606,6915,0,34
"29UGGN","Whitehill",4438,2175,2263,4438,0,28
"29UGGP","Woodlands",6377,3070,3307,6324,53,71
"29UHGF","Allington",6765,3339,3426,6759,6,80
"29UHGG","Barming",2233,1084,1149,2233,0,31
"29UHGH","Bearsted",8010,3836,4174,7918,92,120
"29UHGJ","Boughton Monchelsea and Chart Sutton",2531,1259,1272,2531,0,49
"29UHGK","Boxley",8463,4207,4256,8448,15,128
"29UHGL","Bridge",4712,2326,2386,4437,275,77
"29UHGM","Coxheath and Hunton",6863,3357,3506,6844,19,76
"29UHGN","Detling and Thurnham",2951,1464,1487,2951,0,60
"29UHGP","Downswood and Otham",2752,1392,1360,2752,0,32
"29UHGQ","East",7910,3852,4058,7858,52,104
"29UHGR","Fant",7707,3747,3960,7648,59,54
"29UHGS","Harrietsham and Lenham",5051,2505,2546,4988,63,58
"29UHGT","Headcorn",4815,2347,2468,4768,47,102
"29UHGU","Heath",4563,2238,2325,4248,315,44
"29UHGW","High Street",7774,3819,3955,7699,75,62
"29UHGX","Leeds",2224,1124,1100,2207,17,28
"29UHGY","Loose",2207,1064,1143,2165,42,37
"29UHGZ","Marden and Yalding",7494,3734,3760,7457,37,128
"29UHHA","North",7778,4102,3676,7289,489,78
"29UHHB","North Downs",2331,1142,1189,2331,0,42
"29UHHC","Park Wood",4030,1939,2091,4030,0,14
"29UHHD","Shepway North",8560,4147,4413,8509,51,55
"29UHHE","Shepway South",5389,2574,2815,5387,3,16
"29UHHF","South",7130,3484,3646,7048,82,92
"29UHHG","Staplehurst",6003,2910,3093,5832,171,105
"29UHHH","Sutton Valence and Langley",2702,1358,1344,2522,180,42
"29UKGK","Ash",6594,3260,3334,6594,0,120
"29UKGL","Brasted, Chevening and Sundridge",5920,2850,3070,5821,99,162
"29UKGM","Cowden and Hever",1901,910,991,1884,17,50
"29UKGN","Crockenhill and Well Hill",1860,914,946,1860,0,22
"29UKGP","Dunton Green and Riverhead",4349,2127,2222,4333,16,47
"29UKGQ","Edenbridge North and East",3948,1929,2019,3936,12,62
"29UKGR","Edenbridge South and West",3860,1823,2037,3792,68,53
"29UKGS","Eynsford",1744,834,910,1744,0,19
"29UKGT","Farningham, Horton Kirby and South Darenth",4231,2048,2183,4174,57,29
"29UKGU","Fawkham and West Kingsdown",5782,2880,2902,5761,21,63
"29UKGW","Halstead, Knockholt and Badgers Mount",3259,1614,1645,3259,0,49
"29UKGX","Hartley and Hodsoll Street",5871,2786,3085,5710,161,76
"29UKGY","Hextable",4398,2135,2263,4310,88,51
"29UKGZ","Kemsing",4014,1930,2084,3958,56,63
"29UKHA","Leigh and Chiddingstone Causeway",2040,981,1059,2040,0,50
"29UKHB","Otford and Shoreham",4381,2144,2237,4376,5,89
"29UKHC","Penshurst, Fordcombe and Chiddingstone",2255,1098,1157,2255,0,66
"29UKHD","Seal and Weald",4073,1994,2079,4010,63,108
"29UKHE","Sevenoaks Eastern",3734,1791,1943,3651,83,68
"29UKHF","Sevenoaks Kippington",4532,2272,2260,4377,155,147
"29UKHG","Sevenoaks Northern",4148,2013,2135,4119,29,41
"29UKHH","Sevenoaks Town and St John's",5745,2579,3166,5386,359,149
"29UKHJ","Swanley Christchurch and Swanley Village",5766,2816,2950,5727,39,44
"29UKHK","Swanley St Mary's",4535,2195,2340,4535,0,11
"29UKHL","Swanley White Oak",6287,2967,3320,6287,0,49
"29UKHM","Westerham and Crockham Hill",4078,2001,2077,4052,26,66
"29ULGC","Dymchurch and St Mary's Bay",6187,2990,3197,6105,82,40
"29ULGD","Elham and Stelling Minnis",2027,989,1038,2025,3,49
"29ULGE","Folkestone Cheriton",7138,3412,3726,7092,46,59
"29ULGF","Folkestone East",4755,2222,2533,4755,0,14
"29ULGG","Folkestone Foord",5325,2539,2786,5321,4,28
"29ULGH","Folkestone Harbour",4918,2338,2580,4867,51,26
"29ULGJ","Folkestone Harvey Central",4538,2099,2439,4272,266,19
"29ULGK","Folkestone Harvey West",3809,1719,2090,3492,317,66
"29ULGL","Folkestone Morehall",4262,2010,2252,4258,4,44
"29ULGM","Folkestone Park",6094,2935,3159,5940,154,94
"29ULGN","Folkestone Sandgate",4225,2301,1924,3646,579,44
"29ULGP","Hythe Central",5707,2583,3124,5564,143,55
"29ULGQ","Hythe East",4141,1902,2239,3965,176,43
"29ULGR","Hythe West",4322,2024,2298,4322,0,34
"29ULGS","Lydd",5782,2830,2952,5716,66,25
"29ULGT","Lympne and Stanford",1944,957,987,1905,39,27
"29ULGU","New Romney Coast",3441,1628,1813,3259,182,32
"29ULGW","New Romney Town",3512,1664,1848,3499,13,17
"29ULGX","North Downs East",5790,2855,2935,5770,20,43
"29ULGY","North Downs West",4072,1938,2134,4054,18,63
"29ULGZ","Romney Marsh",2280,1159,1121,2274,6,29
"29ULHA","Tolsford",1969,958,1011,1941,28,31
"29UMGC","Abbey",4887,2319,2568,4816,71,35
"29UMGD","Borden",2154,1033,1121,2102,52,31
"29UMGE","Boughton and Courtenay",5316,2558,2758,5307,9,72
"29UMGF","Chalkwell",5299,2622,2677,5251,48,34
"29UMGG","Davington Priory",2647,1270,1377,2647,0,21
"29UMGH","East Downs",2708,1343,1365,2669,39,50
"29UMGJ","Grove",5145,2484,2661,5058,87,39
"29UMGK","Hartlip, Newington and Upchurch",5656,2750,2906,5588,68,53
"29UMGL","Iwade and Lower Halstow",2357,1183,1174,2357,0,19
"29UMGM","Kemsley",5840,2904,2936,5840,0,26
"29UMGN","Leysdown and Warden",3051,1506,1545,3016,35,14
"29UMGP","Milton Regis",5136,2500,2636,5042,94,30
"29UMGQ","Minster Cliffs",7106,3439,3667,7035,71,45
"29UMGR","Murston",5408,2701,2707,5408,0,29
"29UMGS","Queenborough and Halfway",7657,3734,3923,7639,18,27
"29UMGT","Roman",5082,2463,2619,5046,36,30
"29UMGU","St Ann's",5273,2558,2715,5240,33,38
"29UMGW","St Michaels",4630,2284,2346,4577,53,73
"29UMGX","Sheerness East",5751,2840,2911,5657,94,18
"29UMGY","Sheerness West",5903,2880,3023,5903,0,15
"29UMGZ","Sheppey Central",8384,4700,3684,6989,1395,34
"29UMHA","Teynham and Lynsted",5125,2559,2566,5077,48,51
"29UMHB","Watling",4903,2339,2564,4817,86,42
"29UMHC","West Downs",2514,1231,1283,2514,0,42
"29UMHD","Woodstock",4869,2352,2517,4817,52,69
"29UNGE","Beacon Road",4468,2090,2378,4428,40,33
"29UNGF","Birchington North",3668,1633,2035,3552,116,62
"29UNGG","Birchington South",6159,2800,3359,6133,26,35
"29UNGH","Bradstowe",4071,1865,2206,4009,62,53
"29UNGJ","Central Harbour",7550,3668,3882,7414,136,55
"29UNGK","Cliffsend and Pegwell",4444,2143,2301,4373,71,45
"29UNGL","Cliftonville East",6113,2861,3252,6068,45,75
"29UNGM","Cliftonville West",6939,3409,3530,6264,675,34
"29UNGN","Dane Valley",7978,3725,4253,7970,8,31
"29UNGP","Eastcliff",7018,3369,3649,6738,280,39
"29UNGQ","Garlinge",4858,2316,2542,4856,3,35
"29UNGR","Kingsgate",1970,946,1024,1849,121,26
"29UNGS","Margate Central",4770,2310,2460,4535,235,9
"29UNGT","Nethercourt",4204,1991,2213,4179,25,23
"29UNGU","Newington",5009,2353,2656,5009,0,25
"29UNGW","Northwood",6570,3112,3458,6557,13,13
"29UNGX","St Peters",6761,3126,3635,6681,80,66
"29UNGY","Salmestone",5409,2575,2834,5317,92,32
"29UNGZ","Sir Moses Montefiore",4844,2272,2572,4787,57,22
"29UNHA","Thanet Villages",5886,2869,3017,5874,12,66
"29UNHB","Viking",7100,3319,3781,6828,272,106
"29UNHC","Westbrook",4319,2160,2159,4026,293,41
"29UNHD","Westgate-on-Sea",6594,3044,3550,6036,558,38
"29UPHJ","Aylesford",4548,2272,2276,4470,78,41
"29UPHK","Blue Bell Hill and Walderslade",4091,2026,2065,4078,13,53
"29UPHL","Borough Green and Long Mill",6317,3047,3270,6229,88,135
"29UPHM","Burham, Eccles and Wouldham",3759,1846,1913,3713,46,14
"29UPHN","Cage Green",3978,1880,2098,3964,14,67
"29UPHP","Castle",4761,2496,2265,4226,535,68
"29UPHQ","Ditton",4753,2329,2424,4748,5,48
"29UPHR","Downs",3475,1710,1765,3472,3,68
"29UPHS","East Malling",4448,2158,2290,4448,0,32
"29UPHT","East Peckham and Golden Green",3679,1809,1870,3665,14,47
"29UPHU","Hadlow, Mereworth and West Peckham",4421,2139,2282,4295,126,47
"29UPHW","Higham",5867,2796,3071,5857,10,91
"29UPHX","Hildenborough",4588,2242,2346,4528,60,91
"29UPHY","Ightham",1940,980,960,1940,0,57
"29UPHZ","Judd",4580,2245,2335,4580,0,42
"29UPJA","Kings Hill",3024,1515,1509,3024,0,21
"29UPJB","Larkfield North",3453,1712,1741,3453,0,25
"29UPJC","Larkfield South",4126,2041,2085,4087,39,35
"29UPJD","Medway",4074,1955,2119,4020,54,57
"29UPJE","Snodland East",4112,2009,2103,4092,20,14
"29UPJF","Snodland West",5217,2599,2618,5165,52,20
"29UPJG","Trench",4117,1981,2136,4117,0,25
"29UPJH","Vauxhall",4785,2302,2483,4784,3,55
"29UPJJ","Wateringbury",2015,1006,1009,1977,38,32
"29UPJK","West Malling and Leybourne",5618,2668,2950,5522,96,62
"29UPJL","Wrotham",1815,879,936,1778,37,24
"29UQGB","Benenden and Cranbrook",7588,3436,4152,6775,813,186
"29UQGC","Brenchley and Horsmonden",4884,2452,2432,4884,0,121
"29UQGD","Broadwater",4062,1955,2107,4042,20,77
"29UQGE","Capel",2312,1146,1166,2282,30,31
"29UQGF","Culverden",6311,3010,3301,5963,348,127
"29UQGG","Frittenden and Sissinghurst",2112,1033,1079,2078,34,56
"29UQGH","Goudhurst and Lamberhurst",4695,2308,2387,4318,377,76
"29UQGJ","Hawkhurst and Sandhurst",5688,2737,2951,5572,116,138
"29UQGK","Paddock Wood East",4156,2038,2118,4146,10,41
"29UQGL","Paddock Wood West",4107,2067,2040,4107,0,39
"29UQGM","Pantiles and St Mark's",5950,2787,3163,5797,153,165
"29UQGN","Park",6525,3074,3451,6294,231,140
"29UQGP","Pembury",6005,2919,3086,5858,147,93
"29UQGQ","Rusthall",4776,2256,2520,4721,55,45
"29UQGR","St James'",4599,2196,2403,4533,66,40
"29UQGS","St John's",6690,3254,3436,6681,9,100
"29UQGT","Sherwood",6729,3311,3418,6688,41,50
"29UQGU","Southborough and High Brooms",7143,3460,3683,7137,6,67
"29UQGW","Southborough North",3981,1876,2105,3892,89,90
"29UQGX","Speldhurst and Bidborough",5717,2717,3000,5509,208,190
"30UDGQ","Bank Hall",5884,2810,3074,5826,58,44
"30UDGR","Briercliffe",5871,2879,2992,5816,55,64
"30UDGS","Brunshaw",6298,3003,3295,6290,8,27
"30UDGT","Cliviger with Worsthorne",5358,2624,2734,5299,59,82
"30UDGU","Coal Clough with Deerplay",5410,2597,2813,5321,89,50
"30UDGW","Daneshouse with Stoneyholme",6162,3109,3053,6120,42,77
"30UDGX","Gannow",5838,2765,3073,5750,88,35
"30UDGY","Gawthorpe",6119,2918,3201,6065,54,28
"30UDGZ","Hapton with Park",6084,2991,3093,6007,77,44
"30UDHA","Lanehead",5970,2827,3143,5923,47,62
"30UDHB","Queensgate",5776,2782,2994,5568,208,34
"30UDHC","Rosegrove with Lowerhouse",5916,2857,3059,5883,33,19
"30UDHD","Rosehill with Burnley Wood",6625,3218,3407,6530,95,67
"30UDHE","Trinity",5988,2968,3020,5840,148,25
"30UDHF","Whittlefield with Ightenhill",6243,3060,3183,6218,25,81
"30UEFZ","Adlington and Anderton",6476,3175,3301,6441,35,65
"30UEGA","Astley and Buckshaw",3583,1747,1836,3583,0,66
"30UEGB","Brindle and Hoghton",2218,1083,1135,2132,86,43
"30UEGC","Chisnall",3946,1938,2008,3946,0,42
"30UEGD","Chorley East",6420,3143,3277,6373,47,30
"30UEGE","Chorley North East",6791,3362,3429,6718,73,58
"30UEGF","Chorley North West",6106,2947,3159,5936,170,95
"30UEGG","Chorley South East",5901,2931,2970,5866,35,50
"30UEGH","Chorley South West",6338,3060,3278,6273,65,30
"30UEGJ","Clayton-le-Woods and Whittle-le-Woods",6881,3435,3446,6760,121,77
"30UEGK","Clayton-le-Woods North",6867,3368,3499,6667,200,46
"30UEGL","Clayton-le-Woods West and Cuerden",4217,2123,2094,4160,57,46
"30UEGM","Coppull",6459,3187,3272,6406,53,40
"30UEGN","Eccleston and Mawdesley",6140,3014,3126,6138,3,92
"30UEGP","Euxton North",3930,1888,2042,3930,0,69
"30UEGQ","Euxton South",4134,2046,2088,4079,55,70
"30UEGR","Heath Charnock and Rivington",2209,1100,1109,2140,69,35
"30UEGS","Lostock",5382,3239,2143,4107,1275,79
"30UEGT","Pennine",2198,1087,1111,2198,0,26
"30UEGU","Wheelton and Withnell",4253,2100,2153,4253,0,59
"30UFFZ","Ansdell",4036,1857,2179,3840,196,88
"30UFGA","Ashton",4415,2080,2335,4245,170,79
"30UFGB","Central",4227,1995,2232,4005,222,51
"30UFGC","Clifton",3887,1763,2124,3729,158,51
"30UFGD","Elswick and Little Eccleston",1431,704,727,1431,0,27
"30UFGE","Fairhaven",4047,1870,2177,3812,235,75
"30UFGF","Freckleton East",3199,1517,1682,3132,67,31
"30UFGG","Freckleton West",2846,1390,1456,2846,0,34
"30UFGH","Heyhouses",4401,2039,2362,4361,40,46
"30UFGJ","Kilnhouse",4083,1920,2163,4083,0,30
"30UFGK","Kirkham North",4042,1976,2066,3947,95,44
"30UFGL","Kirkham South",3085,1632,1453,2725,360,23
"30UFGM","Medlar-with-Wesham",3245,1574,1671,3199,46,36
"30UFGN","Newton and Treales",3127,1561,1566,3127,0,53
"30UFGP","Park",3950,1864,2086,3950,0,70
"30UFGQ","Ribby-with-Wrea",1489,755,734,1471,18,33
"30UFGR","St Johns",4056,1958,2098,4028,28,44
"30UFGS","St Leonards",4225,1985,2240,4066,159,35
"30UFGT","Singleton and Greenhalgh",1339,632,707,1281,58,23
"30UFGU","Staining and Weeton",3408,1809,1599,3103,305,28
"30UFGW","Warton and Westby",4679,2262,2417,4672,7,67
"30UGFT","Altham",4686,2343,2343,4577,109,24
"30UGFU","Barnfield",4542,2252,2290,4494,48,48
"30UGFW","Baxenden",4304,2111,2193,4258,46,57
"30UGFX","Central",4839,2367,2472,4820,19,22
"30UGFY","Church",5264,2587,2677,5211,53,20
"30UGFZ","Clayton-le-Moors",5044,2404,2640,4959,85,47
"30UGGA","Huncoat",4321,2107,2214,4269,52,35
"30UGGB","Immanuel",4448,2199,2249,4420,28,38
"30UGGC","Milnshaw",4575,2132,2443,4471,104,27
"30UGGD","Netherton",4729,2293,2436,4710,19,25
"30UGGE","Overton",6488,3165,3323,6415,73,57
"30UGGF","Peel",4511,2198,2313,4463,48,19
"30UGGG","Rishton",7350,3630,3720,7324,26,53
"30UGGH","St Andrew's",4497,2141,2356,4427,70,21
"30UGGJ","St Oswald's",6682,3370,3312,6638,44,58
"30UGGK","Spring Hill",5216,2512,2704,5129,87,21
"30UHGG","Bare",4058,1777,2281,3794,264,43
"30UHGH","Bolton-le-Sands",4159,2015,2144,4133,26,46
"30UHGJ","Bulk",6794,3471,3323,6110,684,41
"30UHGK","Carnforth",4253,2012,2241,4161,92,33
"30UHGL","Castle",6989,3536,3453,6655,334,84
"30UHGM","Duke's",2064,969,1095,1997,67,19
"30UHGN","Ellel",8146,3954,4192,4303,3843,58
"30UHGP","Halton-with-Aughton",2360,1149,1211,2323,37,37
"30UHGQ","Harbour",6708,3287,3421,6582,126,37
"30UHGR","Heysham Central",4397,2047,2350,4283,114,20
"30UHGS","Heysham North",5477,2724,2753,5383,94,22
"30UHGT","Heysham South",6262,2998,3264,6226,36,53
"30UHGU","John O'Gaunt",7100,3257,3843,6622,478,49
"30UHGW","Kellet",2145,1033,1112,2127,18,49
"30UHGX","Lower Lune Valley",4374,2140,2234,4324,50,78
"30UHGY","Overton",2289,1110,1179,2257,32,20
"30UHGZ","Poulton",7868,3739,4129,7647,221,38
"30UHHA","Scotforth East",4573,2147,2426,4521,52,68
"30UHHB","Scotforth West",6163,2864,3299,6103,60,90
"30UHHC","Silverdale",2016,950,1066,1926,90,46
"30UHHD","Skerton East",6665,3183,3482,6659,6,30
"30UHHE","Skerton West",6811,3263,3548,6779,32,45
"30UHHF","Slyne-with-Hest",4199,1992,2207,4073,126,89
"30UHHG","Torrisholme",6758,3159,3599,6730,28,59
"30UHHJ","Upper Lune Valley",2272,1106,1166,2243,29,57
"30UHHK","Warton",2315,1105,1210,2302,13,20
"30UHHL","Westgate",6699,3118,3581,6641,58,33
"30UJFW","Barrowford",4979,2395,2584,4873,106,79
"30UJFX","Blacko and Higherford",1655,841,814,1640,15,20
"30UJFY","Boulsworth",4925,2414,2511,4888,37,64
"30UJFZ","Bradley",6735,3287,3448,6691,44,37
"30UJGA","Brierfield",5232,2573,2659,5160,72,44
"30UJGB","Clover Hill",5236,2571,2665,5212,24,46
"30UJGC","Coates",5508,2654,2854,5458,50,45
"30UJGD","Craven",5589,2764,2825,5553,36,44
"30UJGE","Earby",5999,2986,3013,5979,20,42
"30UJGF","Foulridge",1734,859,875,1734,0,18
"30UJGG","Higham and Pendleside",1672,818,854,1672,0,33
"30UJGH","Horsfield",5314,2465,2849,5233,81,35
"30UJGJ","Marsden",3575,1722,1853,3549,26,35
"30UJGK","Old Laund Booth",1586,786,800,1572,14,26
"30UJGL","Reedley",5404,2675,2729,5360,44,85
"30UJGM","Southfield",5381,2614,2767,5328,53,34
"30UJGN","Vivary Bridge",5965,2835,3130,5899,66,46
"30UJGP","Walverden",3532,1688,1844,3494,38,45
"30UJGQ","Waterside",5024,2456,2568,4984,40,37
"30UJGR","Whitefield",4203,2112,2091,4203,0,57
"30UKFW","Ashton",4430,2111,2319,4314,116,47
"30UKFX","Brookfield",7624,3552,4072,7574,50,45
"30UKFY","Cadley",4698,2246,2452,4613,85,57
"30UKFZ","College",3517,1699,1818,3305,212,67
"30UKGA","Deepdale",5802,2861,2941,5802,0,27
"30UKGB","Fishwick",5303,2543,2760,5267,36,26
"30UKGC","Garrison",6943,3316,3627,6757,186,64
"30UKGD","Greyfriars",6679,3248,3431,6667,12,118
"30UKGE","Ingol",7395,3582,3813,7295,100,39
"30UKGF","Larches",7445,3579,3866,7391,54,34
"30UKGG","Lea",5962,2924,3038,5941,21,50
"30UKGH","Moor Park",4919,2353,2566,4821,98,19
"30UKGJ","Preston Rural East",3814,1861,1953,3764,50,60
"30UKGK","Preston Rural North",6540,3197,3343,6362,178,99
"30UKGL","Ribbleton",7351,3558,3793,7342,9,22
"30UKGM","Riversway",5823,2998,2825,5766,57,41
"30UKGN","St George's",5049,2527,2522,5022,27,24
"30UKGP","St Matthew's",6462,3359,3103,6203,259,28
"30UKGQ","Sharoe Green",6819,3234,3585,6547,272,80
"30UKGR","Town Centre",6671,3436,3235,6581,90,57
"30UKGS","Tulketh",6886,3317,3569,6885,3,21
"30UKGT","University",3501,1621,1880,2836,665,18
"30ULGB","Aighton, Bailey and Chaigley",1623,915,708,1290,333,37
"30ULGC","Alston and Hothersall",2565,1228,1337,2549,16,34
"30ULGD","Billington and Old Langho",2335,1164,1171,2304,31,25
"30ULGE","Bowland, Newton and Slaidburn",1243,634,609,1237,6,23
"30ULGF","Chatburn",1324,627,697,1282,42,13
"30ULGG","Chipping",1337,686,651,1337,0,24
"30ULGH","Clayton-le-Dale with Ramsgreave",2468,1133,1335,2343,125,42
"30ULGJ","Derby and Thornley",3049,1434,1615,3012,37,26
"30ULGK","Dilworth",2395,1168,1227,2352,43,29
"30ULGL","Edisford and Low Moor",2886,1350,1536,2803,83,38
"30ULGM","Gisburn, Rimington",1289,653,636,1280,9,25
"30ULGN","Langho",2303,1162,1141,2239,64,58
"30ULGP","Littlemoor",2815,1353,1462,2792,23,35
"30ULGQ","Mellor",2505,1206,1299,2505,0,53
"30ULGR","Primrose",3036,1468,1568,2995,41,27
"30ULGS","Read and Simonstone",2535,1237,1298,2527,8,70
"30ULGT","Ribchester",1535,764,771,1535,0,26
"30ULGU","Sabden",1371,685,686,1371,0,21
"30ULGW","St Mary's",2865,1388,1477,2826,39,44
"30ULGX","Salthill",3095,1516,1579,3075,20,30
"30ULGY","Waddington and West Bradford",2636,1298,1338,2627,9,56
"30ULGZ","Whalley",2892,1400,1492,2678,214,51
"30ULHA","Wilpshire",2569,1279,1290,2545,24,44
"30ULHB","Wiswell and Pendleton",1289,646,643,1289,0,21
"30UMFP","Cribden",3627,1758,1869,3615,12,57
"30UMFQ","Eden",3544,1704,1840,3466,78,43
"30UMFR","Facit and Shawforth",3588,1766,1822,3545,43,34
"30UMFS","Goodshaw",3594,1787,1807,3558,36,48
"30UMFT","Greenfield",5455,2656,2799,5355,100,76
"30UMFU","Greensclough",5398,2625,2773,5307,91,54
"30UMFW","Hareholme",5471,2642,2829,5319,152,46
"30UMFX","Healey and Whitworth",3675,1834,1841,3660,15,35
"30UMFY","Helmshore",5726,2829,2897,5696,30,71
"30UMFZ","Irwell",4961,2425,2536,4948,13,37
"30UMGA","Longholme",5561,2668,2893,5437,124,67
"30UMGB","Stacksteads",3832,1847,1985,3819,13,19
"30UMGC","Whitewell",5552,2715,2837,5502,50,46
"30UMGD","Worsley",5668,2714,2954,5626,42,27
"30UNFZ","Bamber Bridge East",4431,2165,2266,4356,75,22
"30UNGA","Bamber Bridge North",3943,1954,1989,3886,57,17
"30UNGB","Bamber Bridge West",3752,1763,1989,3714,38,21
"30UNGC","Broad Oak",4220,2005,2215,4204,16,71
"30UNGD","Charnock",3352,1649,1703,3352,0,23
"30UNGE","Coupe Green and Gregson Lane",3555,1728,1827,3540,15,46
"30UNGF","Earnshaw Bridge",3722,1844,1878,3651,71,23
"30UNGG","Farington East",2967,1450,1517,2960,7,26
"30UNGH","Farington West",3633,1819,1814,3633,0,34
"30UNGJ","Golden Hill",3982,1870,2112,3947,35,18
"30UNGK","Howick and Priory",4064,1969,2095,3976,88,79
"30UNGL","Kingsfold",4324,2061,2263,4300,24,26
"30UNGM","Leyland Central",3626,1798,1828,3626,0,20
"30UNGN","Leyland St. Ambrose",3337,1636,1701,3294,43,24
"30UNGP","Leyland St. Mary's",3562,1733,1829,3519,43,69
"30UNGQ","Little Hoole and Much Hoole",3666,1807,1859,3666,0,36
"30UNGR","Longton and Hutton West",5549,2678,2871,5452,97,76
"30UNGS","Lostock Hall",3948,1959,1989,3920,28,19
"30UNGT","Lowerhouse",4050,1906,2144,4014,36,21
"30UNGU","Middleforth",3799,1853,1946,3799,0,31
"30UNGW","Moss Side",3673,1796,1877,3673,0,36
"30UNGX","New Longton and Hutton East",4256,2087,2169,4235,21,65
"30UNGY","Samlesbury and Walton",3893,1919,1974,3852,41,33
"30UNGZ","Seven Stars",3701,1826,1875,3630,71,22
"30UNHA","Tardy Gate",3291,1635,1656,3275,16,23
"30UNHB","Walton-le-Dale",3894,1941,1953,3891,3,32
"30UNHC","Whitefield",3677,1763,1914,3677,0,68
"30UPGD","Ashurst",6732,3289,3443,6732,0,48
"30UPGE","Aughton and Downholland",5644,2741,2903,5526,118,119
"30UPGF","Aughton Park",3907,1868,2039,3822,85,77
"30UPGG","Bickerstaffe",2013,985,1028,2013,0,28
"30UPGH","Birch Green",4477,2095,2382,4443,34,19
"30UPGJ","Burscough East",3597,1732,1865,3518,79,48
"30UPGK","Burscough West",5071,2471,2600,5018,53,59
"30UPGL","Derby",6018,2723,3295,5308,710,92
"30UPGM","Digmoor",4530,2177,2353,4522,8,24
"30UPGN","Halsall",1873,899,974,1841,32,18
"30UPGP","Hesketh-with-Becconsall",3873,1967,1906,3854,19,34
"30UPGQ","Knowsley",5535,2632,2903,5482,53,86
"30UPGR","Moorside",4177,2020,2157,4171,6,14
"30UPGS","Newburgh",2045,1003,1042,2045,0,36
"30UPGT","North Meols",3792,1857,1935,3738,54,21
"30UPGU","Parbold",3890,1836,2054,3803,87,99
"30UPGW","Rufford",2048,1015,1033,2027,21,21
"30UPGX","Scarisbrick",3504,1765,1739,3475,29,33
"30UPGY","Scott",5681,2680,3001,5628,53,58
"30UPGZ","Skelmersdale North",4199,1996,2203,4157,42,12
"30UPHA","Skelmersdale South",6329,3083,3246,6277,52,25
"30UPHB","Tanhouse",4106,1948,2158,4055,51,7
"30UPHC","Tarleton",5350,2614,2736,5350,0,67
"30UPHD","Up Holland",5932,2892,3040,5926,6,50
"30UPHE","Wrightington",4055,1949,2106,3912,143,65
"30UQGE","Bourne",6121,2926,3195,6069,52,41
"30UQGF","Breck",3061,1382,1679,2931,130,38
"30UQGG","Brock",2083,1018,1065,1631,452,29
"30UQGH","Cabus",1572,784,788,1570,3,12
"30UQGJ","Calder",1751,847,904,1663,88,21
"30UQGK","Carleton",4159,1968,2191,4159,0,69
"30UQGL","Catterall",2324,1149,1175,2308,16,33
"30UQGM","Cleveleys Park",5994,2800,3194,5972,22,34
"30UQGN","Garstang",4549,2164,2385,4507,42,56
"30UQGP","Great Eccleston",3522,1718,1804,3477,45,58
"30UQGQ","Hambleton and Stalmine-with-Staynall",4154,2002,2152,4074,80,45
"30UQGR","Hardhorn",3379,1555,1824,3379,0,51
"30UQGS","High Cross",3716,1787,1929,3676,40,49
"30UQGT","Jubilee",4186,1930,2256,3988,198,27
"30UQGU","Mount",4081,1900,2181,4081,0,11
"30UQGW","Norcross",3738,1759,1979,3692,46,25
"30UQGX","Park",4511,2203,2308,4428,83,25
"30UQGY","Pharos",5670,2745,2925,5611,59,15
"30UQGZ","Pilling",2074,1056,1018,2022,52,20
"30UQHA","Preesall",5314,2481,2833,5238,76,23
"30UQHB","Rossall",6539,3084,3455,6249,290,39
"30UQHC","Staina",5267,2481,2786,5236,31,55
"30UQHD","Tithebarn",3949,1816,2133,3945,4,56
"30UQHE","Victoria",5851,2769,3082,5851,0,77
"30UQHF","Warren",6040,2929,3111,5878,162,45
"30UQHG","Wyresdale",2013,988,1025,1947,66,32
"31UBFY","Blaby South",4809,2366,2443,4802,7,29
"31UBFZ","Cosby with South Whetstone",4901,2395,2506,4878,23,39
"31UBGA","Countesthorpe",6666,3271,3395,6627,39,66
"31UBGB","Croft Hill",2251,1133,1118,2251,0,26
"31UBGC","Ellis",5034,2488,2546,5034,0,44
"31UBGD","Enderby and St John's",4042,1968,2074,4018,24,21
"31UBGE","Fairestone",4687,2310,2377,4672,15,47
"31UBGF","Forest",6893,3380,3513,6724,169,73
"31UBGG","Millfield",2252,1105,1147,2252,0,26
"31UBGH","Muxloe",4126,2009,2117,4107,19,59
"31UBGJ","Narborough and Littlethorpe",5128,2578,2550,5093,35,37
"31UBGK","Normanton",2551,1260,1291,2551,0,19
"31UBGL","North Whetstone",4846,2399,2447,4790,56,22
"31UBGM","Pastures",4949,2470,2479,4900,49,52
"31UBGN","Ravenhurst and Fosse",7158,3513,3645,7147,11,57
"31UBGP","Saxondale",7256,3884,3372,6506,750,46
"31UBGQ","Stanton and Flamville",7132,3532,3600,7079,53,106
"31UBGR","Winstanley",5571,2790,2781,5571,0,24
"31UCGG","Anstey",5821,2810,3011,5821,0,46
"31UCGH","Barrow and Sileby West",5627,2773,2854,5595,32,58
"31UCGJ","Birstall Wanlip",5125,2510,2615,5114,11,63
"31UCGK","Birstall Watermead",6513,3212,3301,6485,28,59
"31UCGL","East Goscote",2809,1391,1418,2789,20,29
"31UCGM","Forest Bradgate",3046,1460,1586,2944,102,47
"31UCGN","Loughborough Ashby",6904,3821,3083,3443,3461,11
"31UCGP","Loughborough Dishley and Hathern",5720,2815,2905,5719,0,78
"31UCGQ","Loughborough Garendon",6071,3018,3053,6032,39,84
"31UCGR","Loughborough Hastings",5472,2710,2762,5437,35,45
"31UCGS","Loughborough Lemyngton",5332,2705,2627,5277,55,27
"31UCGT","Loughborough Nanpantan",5402,2896,2506,4014,1388,105
"31UCGU","Loughborough Outwoods",5556,2759,2797,5355,201,89
"31UCGW","Loughborough Shelthorpe",6320,3082,3238,6282,38,38
"31UCGX","Loughborough Southfields",5277,2631,2646,4780,497,48
"31UCGY","Loughborough Storer",5572,2871,2701,5083,489,29
"31UCGZ","Mountsorrel",6662,3277,3385,6653,9,30
"31UCHA","Queniborough",2927,1415,1512,2905,22,41
"31UCHB","Quorn and Mountsorrel Castle",5993,2899,3094,5864,129,79
"31UCHC","Rothley and Thurcaston",5911,2892,3019,5884,27,92
"31UCHD","Shepshed East",6416,3193,3223,6375,41,70
"31UCHE","Shepshed West",6466,3169,3297,6355,111,56
"31UCHF","Sileby",6331,3153,3178,6292,39,43
"31UCHG","Syston East",5814,2791,3023,5787,27,34
"31UCHH","Syston West",5794,2774,3020,5710,84,60
"31UCHJ","The Wolds",2801,1382,1419,2767,34,60
"31UCHK","Thurmaston",8945,4465,4480,8892,53,88
"31UCHL","Wreake Villages",2835,1444,1391,2690,145,50
"31UDGD","Billesdon",1586,778,808,1586,0,43
"31UDGE","Bosworth",2134,1075,1059,2085,49,39
"31UDGF","Broughton Astley - Astley",2260,1133,1127,2260,0,16
"31UDGG","Broughton Astley - Broughton",2286,1148,1138,2286,0,41
"31UDGH","Broughton Astley - Primethorpe",1851,909,942,1850,0,17
"31UDGJ","Broughton Astley - Sutton",1893,972,921,1878,15,13
"31UDGK","Dunton",2159,1081,1078,2159,0,35
"31UDGL","Fleckney",4613,2304,2309,4609,4,57
"31UDGM","Glen",3876,1910,1966,3876,0,64
"31UDGN","Kibworth",6081,2912,3169,5927,154,106
"31UDGP","Lubenham",2419,1338,1081,2094,325,24
"31UDGQ","Lutterworth Brookfield",2203,1103,1100,2203,0,43
"31UDGR","Lutterworth Orchard",2152,1054,1098,2113,39,15
"31UDGS","Lutterworth Springs",2085,1000,1085,2076,9,28
"31UDGT","Lutterworth Swift",1853,910,943,1853,0,23
"31UDGU","Market Harborough - Great Bowden and Arden",6519,3176,3343,6437,82,80
"31UDGW","Market Harborough - Little Bowden",3862,1927,1935,3862,0,31
"31UDGX","Market Harborough - Logan",4060,1958,2102,4002,58,57
"31UDGY","Market Harborough - Welland",5686,2753,2933,5596,90,36
"31UDGZ","Misterton",2442,1291,1151,2381,61,28
"31UDHA","Nevill",1970,981,989,1923,47,37
"31UDHB","Peatling",2147,1077,1070,2133,14,46
"31UDHC","Thurnby and Houghton",6516,3184,3332,6269,247,122
"31UDHD","Tilton",1857,956,901,1849,8,55
"31UDHE","Ullesthorpe",2049,1039,1010,2000,49,37
"31UEFU","Ambien",3488,1751,1737,3290,198,44
"31UEFW","Barlestone, Nailstone and Osbaston",3258,1603,1655,3258,0,29
"31UEFX","Barwell",8781,4345,4436,8737,44,63
"31UEFY","Burbage St Catherines and Lash Hill",5811,2790,3021,5773,38,59
"31UEFZ","Burbage Sketchley and Stretton",8513,4210,4303,8511,3,116
"31UEGA","Cadeby, Carlton and Market Bosworth with Shackerstone",3189,1564,1625,3145,44,67
"31UEGB","Earl Shilton",9065,4451,4614,8975,90,58
"31UEGC","Groby",6747,3337,3410,6747,0,102
"31UEGD","Hinckley Castle",5922,2939,2983,5863,59,21
"31UEGE","Hinckley Clarendon",7165,3496,3669,7162,3,28
"31UEGF","Hinckley De Montfort",9312,4520,4792,9260,52,109
"31UEGG","Hinckley Trinity",6523,3245,3278,6510,13,29
"31UEGH","Markfield, Stanton and Fieldhead",5661,2714,2947,5600,61,64
"31UEGJ","Newbold Verdon with Desford and Peckleton",7946,3938,4008,7867,79,132
"31UEGK","Ratby, Bagworth and Thornton",5698,2766,2932,5692,6,38
"31UEGL","Twycross and Witherley with Sheepy",3062,1497,1565,3062,0,63
"31UGFT","Asfordby",3107,1529,1578,3107,0,23
"31UGFU","Bottesford",3436,1689,1747,3436,0,60
"31UGFW","Croxton Kerrial",1662,816,846,1662,0,34
"31UGFX","Frisby-on-the-Wreake",1773,874,899,1736,37,37
"31UGFY","Gaddesby",1643,817,826,1643,0,33
"31UGFZ","Long Clawson and Stathern",3929,1988,1941,3925,4,66
"31UGGA","Melton Craven",3729,1857,1872,3729,0,38
"31UGGB","Melton Dorian",4784,2360,2424,4766,18,36
"31UGGC","Melton Egerton",3756,1824,1932,3702,54,23
"31UGGD","Melton Newport",4897,2368,2529,4850,47,54
"31UGGE","Melton Sysonby",4996,2450,2546,4921,75,62
"31UGGF","Melton Warwick",3392,1609,1783,3309,83,39
"31UGGG","Old Dalby",1901,915,986,1866,35,30
"31UGGH","Somerby",1744,889,855,1744,0,34
"31UGGJ","Waltham-on-the-Wolds",1585,765,820,1492,93,31
"31UGGK","Wymondham",1532,784,748,1518,14,31
"31UHFZ","Appleby",2091,1044,1047,2091,0,33
"31UHGA","Ashby Castle",2632,1310,1322,2601,31,43
"31UHGB","Ashby Holywell",4420,2211,2209,4420,0,59
"31UHGC","Ashby Ivanhoe",4526,2112,2414,4386,140,75
"31UHGD","Bardon",2225,1089,1136,2225,0,5
"31UHGE","Breedon",2376,1186,1190,2376,0,45
"31UHGF","Castle Donington",6533,3307,3226,6528,5,61
"31UHGG","Coalville",4496,2183,2313,4348,148,18
"31UHGH","Greenhill",6891,3358,3533,6778,113,62
"31UHGJ","Hugglescote",4189,2078,2111,4169,20,20
"31UHGK","Ibstock and Heather",6709,3348,3361,6650,59,37
"31UHGL","Kegworth and Whatton",4290,2149,2141,4241,49,53
"31UHGM","Measham",4849,2410,2439,4837,12,28
"31UHGN","Moira",4676,2309,2367,4659,17,36
"31UHGP","Oakthorpe and Donisthorpe",2336,1147,1189,2336,0,20
"31UHGQ","Ravenstone and Packington",2381,1171,1210,2377,4,24
"31UHGR","Snibston",5055,2491,2564,5044,11,23
"31UHGS","Thringstone",4325,2148,2177,4277,48,33
"31UHGT","Valley",4013,1993,2020,4013,0,50
"31UHGU","Whitwick",6490,3196,3294,6480,10,37
"31UJFL","Oadby Brocks Hill",3972,1919,2053,3898,74,60
"31UJFM","Oadby Grange",6100,3013,3087,4527,1573,120
"31UJFN","Oadby St Peter's",3937,1825,2112,3904,33,51
"31UJFP","Oadby Uplands",4404,2137,2267,4404,0,72
"31UJFQ","Oadby Woodlands",4266,2094,2172,4266,0,86
"31UJFR","South Wigston",7471,3611,3860,7381,90,30
"31UJFS","Wigston All Saints",6270,3036,3234,6169,101,48
"31UJFT","Wigston Fields",6647,3254,3393,6628,19,47
"31UJFU","Wigston Meadowcourt",6417,3190,3227,6414,3,54
"31UJFW","Wigston St Wolstan's",6311,3111,3200,6182,129,64
"32UBFT","Central",1699,847,852,1682,17,7
"32UBFU","Coastal",3851,2030,1821,3655,196,37
"32UBFW","Fenside",3619,1700,1919,3619,0,20
"32UBFX","Fishtoft",5444,2652,2792,5380,64,58
"32UBFY","Five Village",3321,1686,1635,3321,0,33
"32UBFZ","Frampton and Holme",1584,792,792,1559,25,34
"32UBGA","Kirton",3635,1728,1907,3574,61,32
"32UBGB","North",3263,1546,1717,3163,100,75
"32UBGC","Old Leake and Wrangle",3068,1533,1535,3053,15,27
"32UBGD","Pilgrim",1709,860,849,1567,142,13
"32UBGE","Skirbeck",5055,2409,2646,5028,27,22
"32UBGF","South",1831,913,918,1683,148,10
"32UBGG","Staniland South",3434,1606,1828,3332,102,22
"32UBGH","Staniland North",1701,809,892,1684,17,9
"32UBGJ","Swineshead and Holland Fen",3369,1726,1643,3369,0,38
"32UBGK","West",1556,759,797,1556,0,23
"32UBGL","Witham",3821,1883,1938,3759,62,21
"32UBGM","Wyberton",3790,1854,1936,3777,13,38
"32UCHC","Alford",4333,2098,2235,4244,89,40
"32UCHD","Binbrook",1853,925,928,1843,10,30
"32UCHE","Burgh le Marsh",2338,1140,1198,2298,40,24
"32UCHF","Chapel St Leonards",4613,2248,2365,4515,98,24
"32UCHG","Coningsby and Tattershall",5551,2839,2712,5201,350,74
"32UCHH","Croft",2289,1173,1116,2289,0,26
"32UCHJ","Frithville",2032,1037,995,2032,0,20
"32UCHK","Grimoldby",2105,1066,1039,2105,0,25
"32UCHL","Halton Holegate",2344,1188,1156,2275,69,40
"32UCHM","Holton le Clay",3875,1939,1936,3875,0,58
"32UCHN","Horncastle",6340,3045,3295,6255,85,61
"32UCHP","Hundleby",2093,1037,1056,2079,14,56
"32UCHQ","Ingoldmells",2273,1166,1107,1765,508,7
"32UCHR","Legbourne",1965,989,976,1961,4,38
"32UCHS","Ludford",2068,1023,1045,2065,3,35
"32UCHT","Mablethorpe Central",2023,983,1040,1908,115,15
"32UCHU","Mablethorpe East",1894,900,994,1849,45,5
"32UCHW","Mablethorpe North",2002,981,1021,1966,36,6
"32UCHX","Mareham le Fen",2077,1046,1031,2077,0,36
"32UCHY","Marshchapel",2229,1105,1124,2224,5,26
"32UCHZ","North Holme",2329,1113,1216,2274,55,35
"32UCJA","North Somercotes",1853,935,918,1853,0,21
"32UCJB","North Thoresby",2062,1011,1051,2062,0,39
"32UCJC","Priory",2222,1063,1159,2191,31,23
"32UCJD","Roughton",2238,1166,1072,2210,28,27
"32UCJE","St Clement's",4840,2290,2550,4804,36,20
"32UCJF","St James'",2144,1031,1113,2089,55,28
"32UCJG","St Margaret's",2522,1204,1318,2459,63,28
"32UCJH","St Mary's",2022,965,1057,1987,35,32
"32UCJJ","St Michael's",2513,1228,1285,2470,43,34
"32UCJK","Scarbrough",4732,2303,2429,4603,129,28
"32UCJL","Seacroft",4451,2085,2366,4253,198,40
"32UCJM","Sibsey",1996,978,1018,1996,0,19
"32UCJN","Skidbrooke with Saltfleet Haven",2108,1057,1051,2083,25,15
"32UCJP","Spilsby",2336,1105,1231,2264,72,18
"32UCJQ","Stickney",2175,1099,1076,2147,28,22
"32UCJR","Sutton on Sea North",1901,860,1041,1739,162,10
"32UCJS","Sutton on Sea South",2068,984,1084,2068,0,4
"32UCJT","Tetford",2090,1033,1057,2049,41,40
"32UCJU","Tetney",2485,1230,1255,2417,68,32
"32UCJW","Trinity",2178,1063,1115,2172,6,15
"32UCJX","Trusthorpe and Mablethorpe South",1892,931,961,1870,22,15
"32UCJY","Wainfleet and Friskney",4093,2034,2059,3991,102,27
"32UCJZ","Willoughby with Sloothby",1989,1008,981,1980,9,21
"32UCKA","Winthorpe",4887,2424,2463,4816,71,35
"32UCKB","Withern with Stain",1979,1006,973,1955,24,21
"32UCKC","Woodhall Spa",3964,1881,2083,3810,154,50
"32UCKD","Wragby",2081,1038,1043,2081,0,15
"32UDFM","Abbey",7330,3895,3435,6576,754,58
"32UDFN","Birchwood",7800,3764,4036,7784,16,41
"32UDFP","Boultham",7970,3853,4117,7862,108,43
"32UDFQ","Bracebridge",8366,4140,4226,8293,73,76
"32UDFR","Carholme",7162,3475,3687,7004,158,76
"32UDFS","Castle",6684,3159,3525,6599,85,38
"32UDFT","Glebe",8376,4024,4352,8359,17,56
"32UDFU","Hartsholme",8890,4328,4562,8719,171,63
"32UDFW","Minster",7132,3242,3890,6853,279,65
"32UDFX","Moorland",7854,3792,4062,7822,32,50
"32UDFY","Park",8031,4023,4008,7844,187,35
"32UEGH","Ashby de la Launde",2556,1317,1239,2382,174,37
"32UEGJ","Bassingham",2598,1257,1341,2551,47,42
"32UEGK","Billinghay",2170,1053,1117,2130,40,16
"32UEGL","Bracebridge Heath and Waddington East",8120,4031,4089,7686,434,88
"32UEGM","Branston and Mere",4667,2275,2392,4618,49,71
"32UEGN","Brant Broughton",2483,1164,1319,2300,183,43
"32UEGP","Cliff Villages",4500,2139,2361,4385,115,63
"32UEGQ","Cranwell and Byard's Leap",2876,1560,1316,2511,365,49
"32UEGR","Eagle and North Scarle",2069,1024,1045,2038,31,25
"32UEGS","Heckington Rural",4705,2348,2357,4669,36,56
"32UEGT","Heighington and Washingborough",6613,3210,3403,6570,43,100
"32UEGU","Kyme",2613,1292,1321,2569,44,34
"32UEGW","Leasingham and Roxholm",2060,997,1063,2023,37,36
"32UEGX","Martin",2034,1003,1031,1995,39,20
"32UEGY","Metheringham",4700,2347,2353,4620,80,48
"32UEGZ","North Hykeham Forum",2334,1114,1220,2334,0,22
"32UEHA","North Hykeham Memorial",2372,1156,1216,2347,25,19
"32UEHB","North Hykeham Mill",2237,1075,1162,2216,21,19
"32UEHC","North Hykeham Moor",2392,1172,1220,2383,9,20
"32UEHD","North Hykeham Witham",2203,1023,1180,2151,52,21
"32UEHE","Osbournby",2119,1047,1072,2114,5,39
"32UEHF","Ruskington",5169,2479,2690,5134,35,42
"32UEHG","Skellingthorpe",3444,1662,1782,3374,70,30
"32UEHH","Sleaford Castle",2645,1301,1344,2639,6,18
"32UEHJ","Sleaford Holdingham",2555,1262,1293,2555,0,18
"32UEHK","Sleaford Mareham",2315,1142,1173,2295,20,33
"32UEHL","Sleaford Navigation",1800,824,976,1721,79,13
"32UEHM","Sleaford Quarrington",2767,1340,1427,2767,0,41
"32UEHN","Sleaford Westholme",2412,1157,1255,2393,19,17
"32UEHP","Waddington West",2496,1246,1250,2490,6,26
"32UFGA","Crowland",3607,1797,1810,3573,34,35
"32UFGB","Deeping St Nicholas",1323,676,647,1323,0,20
"32UFGC","Donington",3807,1857,1950,3781,26,58
"32UFGD","Fleet",2132,1069,1063,1990,142,20
"32UFGE","Gedney",2305,1191,1114,2261,44,35
"32UFGF","Gosberton Village",1864,878,986,1784,80,26
"32UFGG","Holbeach Hurn",2131,1074,1057,2102,29,17
"32UFGH","Holbeach St John's",1675,835,840,1667,8,23
"32UFGJ","Holbeach Town",6457,3080,3377,6404,53,37
"32UFGK","Long Sutton",6461,3104,3357,6366,95,50
"32UFGL","Pinchbeck",5153,2488,2665,5137,16,62
"32UFGM","Spalding Castle",2170,1058,1112,2156,14,31
"32UFGN","Spalding Monks House",4324,2138,2186,4276,48,31
"32UFGP","Spalding St John's",4363,2142,2221,4250,113,55
"32UFGQ","Spalding St Mary's",3619,1689,1930,3566,53,56
"32UFGR","Spalding St Paul's",4059,1926,2133,4050,9,42
"32UFGS","Spalding Wygate",4397,2139,2258,4347,50,43
"32UFGT","Surfleet",2235,1119,1116,2235,0,24
"32UFGU","Sutton Bridge",3936,1928,2008,3870,66,24
"32UFGW","The Saints",2172,1094,1078,2172,0,29
"32UFGX","Weston and Moulton",5824,2897,2927,5797,27,53
"32UFGY","Whaplode",2508,1222,1286,2508,0,23
"32UGGM","All Saints",4811,2357,2454,4807,4,37
"32UGGN","Aveland",2097,1057,1040,2067,30,30
"32UGGP","Barrowby",1996,988,1008,1936,60,33
"32UGGQ","Belmont",4344,2203,2141,4325,19,49
"32UGGR","Bourne East",6124,2936,3188,6060,64,79
"32UGGS","Bourne West",5809,2828,2981,5685,124,110
"32UGGT","Deeping St James",6923,3431,3492,6917,6,112
"32UGGU","Earlesfield",7074,3407,3667,7064,10,26
"32UGGW","Ermine",2496,1228,1268,2488,8,20
"32UGGX","Forest",1916,942,974,1916,0,30
"32UGGY","Glen Eden",2187,1094,1093,2187,0,53
"32UGGZ","Grantham St John's",4309,2144,2165,4301,8,19
"32UGHA","Green Hill",3810,1813,1997,3661,149,52
"32UGHB","Greyfriars",3896,1916,1980,3839,57,52
"32UGHC","Harrowby",6150,2929,3221,6091,59,52
"32UGHD","Heath",1973,902,1071,1800,173,33
"32UGHE","Hillsides",2065,1025,1040,2038,27,57
"32UGHF","Isaac Newton",2156,1106,1050,2148,8,45
"32UGHG","Lincrest",2154,1055,1099,2154,0,51
"32UGHH","Loveden",2200,1108,1092,2173,27,26
"32UGHJ","Market and West Deeping",6477,3176,3301,6408,69,105
"32UGHK","Morkery",2340,1142,1198,2340,0,39
"32UGHL","Peascliffe",2050,987,1063,2050,0,24
"32UGHM","Ringstone",2800,1418,1382,2789,11,26
"32UGHN","St Anne's",4533,2215,2318,4417,116,49
"32UGHP","St George's",3947,1912,2035,3870,77,28
"32UGHQ","St Mary's",4517,2145,2372,4207,310,82
"32UGHR","St Wulfram's",4146,1985,2161,4049,97,70
"32UGHS","Saxonwell",2178,1056,1122,2163,15,47
"32UGHT","Stamford St John's",6250,3110,3140,6232,18,113
"32UGHU","Thurlby",2136,1080,1056,2136,0,47
"32UGHW","Toller",2224,1088,1136,2191,33,24
"32UGHX","Truesdale",4562,2256,2306,4527,35,58
"32UGHY","Witham Valley",2142,1069,1073,2142,0,47
"32UHGD","Bardney",1814,900,914,1786,28,25
"32UHGE","Caistor",3133,1505,1628,3087,46,36
"32UHGF","Cherry Willingham",3761,1808,1953,3726,35,36
"32UHGG","Dunholme",2097,1026,1071,2068,29,33
"32UHGH","Fiskerton",1842,922,920,1796,46,19
"32UHGJ","Gainsborough East",5960,2928,3032,5891,69,29
"32UHGK","Gainsborough North",6642,3263,3379,6609,33,38
"32UHGL","Gainsborough South-West",4267,2108,2159,4220,47,22
"32UHGM","Hemswell",2299,1155,1144,2241,58,33
"32UHGN","Kelsey",2378,1198,1180,2378,0,46
"32UHGP","Lea",2103,1013,1090,2076,27,32
"32UHGQ","Market Rasen",4675,2252,2423,4505,170,74
"32UHGR","Middle Rasen",2238,1103,1135,2203,35,41
"32UHGS","Nettleham",4369,2114,2255,4224,145,100
"32UHGT","Saxilby",4248,2091,2157,4149,99,76
"32UHGU","Scampton",2476,1235,1241,2454,22,59
"32UHGW","Scotter",3977,1934,2043,3899,78,82
"32UHGX","Stow",2159,1030,1129,2094,65,33
"32UHGY","Sudbrooke",2496,1224,1272,2471,25,64
"32UHGZ","Thonock",2363,1130,1233,2272,91,24
"32UHHA","Torksey",2342,1172,1170,2316,26,25
"32UHHB","Waddingham and Spital",2116,1061,1055,2116,0,27
"32UHHC","Welton",5000,2443,2557,4969,31,96
"32UHHD","Wold View",2330,1173,1157,2298,32,30
"32UHHE","Yarborough",2430,1189,1241,2430,0,41
"33UBGU","All Saints",2322,1183,1139,2316,6,29
"33UBGW","Buckenham",1762,878,884,1726,36,21
"33UBGX","Burgh and Haverscroft",3736,1811,1925,3711,25,27
"33UBGY","Conifer",2132,1044,1088,2108,24,17
"33UBGZ","Dereham-Central",5156,2448,2708,5095,61,27
"33UBHA","Dereham-Humbletoft",2195,1061,1134,2154,41,20
"33UBHB","Dereham-Neatherd",3818,1806,2012,3648,170,26
"33UBHC","Dereham-Toftwood",4490,2221,2269,4485,5,21
"33UBHD","East Guiltcross",2221,1158,1063,2089,132,37
"33UBHE","Eynsford",2207,1098,1109,2182,25,19
"33UBHF","Haggard de Toni",2287,1115,1172,2284,3,16
"33UBHG","Harling and Heathlands",4210,2108,2102,4154,56,49
"33UBHH","Hermitage",2115,1051,1064,2066,49,42
"33UBHJ","Launditch",2058,1003,1055,2049,9,48
"33UBHK","Mid Forest",2053,1046,1007,2053,0,23
"33UBHL","Nar Valley",2243,1090,1153,2243,0,25
"33UBHM","Necton",1865,917,948,1848,17,8
"33UBHN","Queen's",6527,3187,3340,6405,122,48
"33UBHP","Shipdham",2145,1023,1122,2113,32,16
"33UBHQ","Springvale and Scarning",4908,2402,2506,4829,79,54
"33UBHR","Swaffham",6935,3256,3679,6745,190,65
"33UBHS","Swanton Morley",2863,1561,1302,2580,283,28
"33UBHT","Taverner",2199,1079,1120,2174,25,27
"33UBHU","Templar",3080,1847,1233,2417,663,34
"33UBHW","Thetford-Abbey",5133,2490,2643,5083,50,25
"33UBHX","Thetford-Castle",1962,967,995,1845,117,13
"33UBHY","Thetford-Guildhall",6795,3451,3344,6795,0,39
"33UBHZ","Thetford-Saxon",7698,3793,3905,7659,39,36
"33UBJA","Two Rivers",4000,1976,2024,3950,50,38
"33UBJB","Upper Wensum",2284,1139,1145,2284,0,28
"33UBJC","Upper Yare",2304,1144,1160,2299,5,42
"33UBJD","Watton",6819,3274,3545,6696,123,44
"33UBJE","Wayland",2078,1039,1039,2078,0,31
"33UBJF","Weeting",2324,1145,1179,2310,14,15
"33UBJG","West Guiltcross",2124,1085,1039,2124,0,34
"33UBJH","Wissey",2370,1182,1188,2351,19,24
"33UCGN","Acle",2732,1299,1433,2698,34,27
"33UCGP","Aylsham",6765,3251,3514,6673,92,73
"33UCGQ","Blofield with South Walsham",5297,2563,2734,5255,42,80
"33UCGR","Brundall",5580,2702,2878,5456,124,81
"33UCGS","Burlingham",2504,1256,1248,2473,31,23
"33UCGT","Buxton",2574,1294,1280,2538,36,32
"33UCGU","Coltishall",2509,1175,1334,2403,106,32
"33UCGW","Drayton North",2884,1437,1447,2884,0,13
"33UCGX","Drayton South",2266,1061,1205,2152,114,27
"33UCGY","Eynesford",2770,1355,1415,2746,24,29
"33UCGZ","Great Witchingham",2330,1151,1179,2325,5,51
"33UCHA","Hellesdon North West",6017,2932,3085,5844,173,48
"33UCHB","Hellesdon South East",5160,2548,2612,5084,76,36
"33UCHC","Hevingham",2596,1306,1290,2586,10,23
"33UCHD","Horsford and Felthorpe",4675,2322,2353,4580,95,28
"33UCHE","Marshes",2711,1339,1372,2711,0,31
"33UCHF","Old Catton and Sprowston West",7543,3654,3889,7526,17,75
"33UCHG","Plumstead",2618,1320,1298,2477,141,44
"33UCHH","Reepham",2455,1173,1282,2454,0,49
"33UCHJ","Spixworth with St Faiths",5450,2716,2734,5438,12,37
"33UCHK","Sprowston Central",5533,2666,2867,5500,33,29
"33UCHL","Sprowston East",6905,3410,3495,6876,29,37
"33UCHM","Taverham North",5423,2663,2760,5239,184,39
"33UCHN","Taverham South",4810,2394,2416,4772,38,63
"33UCHP","Thorpe St Andrew North West",7286,3432,3854,7286,0,37
"33UCHQ","Thorpe St Andrew South East",6476,3117,3359,6252,224,85
"33UCHR","Wroxham",4644,2234,2410,4517,127,64
"33UDFY","Bradwell North",6439,3158,3281,6385,54,60
"33UDFZ","Bradwell South and Hopton",6159,2943,3216,6102,57,39
"33UDGA","Caister North",4528,2217,2311,4500,28,26
"33UDGB","Caister South",4423,2124,2299,4400,23,22
"33UDGC","Central and Northgate",7179,3544,3635,6840,339,30
"33UDGD","Claydon",7426,3540,3886,7400,26,38
"33UDGE","East Flegg",4589,2198,2391,4439,150,48
"33UDGF","Fleggburgh",2337,1136,1201,2337,0,30
"33UDGG","Gorleston",4466,2138,2328,4327,139,60
"33UDGH","Lothingland",5596,2759,2837,5571,25,65
"33UDGJ","Magdalen",7287,3445,3842,7122,165,31
"33UDGK","Nelson",7213,3490,3723,7040,173,23
"33UDGL","Ormesby",4318,2127,2191,4286,32,46
"33UDGM","St Andrews",4847,2377,2470,4819,28,20
"33UDGN","Southtown and Cobholm",4615,2292,2323,4615,0,5
"33UDGP","West Flegg",4707,2322,2385,4676,31,38
"33UDGQ","Yarmouth North",4681,2199,2482,4582,99,28
"33UEGT","Airfield",4962,2681,2281,4253,709,77
"33UEGU","Brancaster",1484,719,765,1468,16,40
"33UEGW","Burnham",1917,923,994,1915,3,34
"33UEGX","Clenchwarton",2200,1075,1125,2200,0,19
"33UEGY","Denton",7602,3807,3795,7567,35,64
"33UEGZ","Dersingham",4502,2103,2399,4472,30,52
"33UEHA","Docking",2006,1042,964,1831,175,22
"33UEHB","Downham Old Town",1996,920,1076,1916,80,14
"33UEHC","East Downham",1440,665,775,1440,0,15
"33UEHD","Emneth with Outwell",4346,2096,2250,4313,33,38
"33UEHE","Fairstead",4956,2360,2596,4952,4,27
"33UEHF","Gayton",2161,1066,1095,2142,19,25
"33UEHG","Gaywood Chase",4740,2290,2450,4623,117,46
"33UEHH","Gaywood North Bank",7563,3680,3883,7560,3,73
"33UEHJ","Grimston",2320,1126,1194,2320,0,37
"33UEHK","Heacham",4611,2139,2472,4502,109,32
"33UEHL","Hilgay with Denver",2185,1092,1093,2185,0,33
"33UEHM","Hunstanton",5685,2572,3113,5426,259,69
"33UEHN","Mershe Lande",2421,1183,1238,2376,45,11
"33UEHP","North Downham",1545,683,862,1495,50,7
"33UEHQ","North Lynn",5506,2616,2890,5444,62,14
"33UEHR","North Wootton",2387,1155,1232,2361,26,51
"33UEHS","Old Gaywood",1812,855,957,1801,11,17
"33UEHT","Priory",2245,1125,1120,2245,0,30
"33UEHU","Rudham",2228,1111,1117,2228,0,34
"33UEHW","St Lawrence",2418,1180,1238,2384,34,17
"33UEHX","St Margarets with St Nicholas",3837,1883,1954,3710,127,22
"33UEHY","Snettisham",3847,1842,2005,3790,57,39
"33UEHZ","South and West Lynn",4136,2043,2093,4136,0,15
"33UEJA","South Downham",1749,801,948,1749,0,12
"33UEJB","South Wootton",3957,1934,2023,3891,66,89
"33UEJC","Spellowfields",4465,2185,2280,4441,24,33
"33UEJD","Springwood",1999,967,1032,1857,142,51
"33UEJE","Upwell and Delph",4304,2152,2152,4266,38,35
"33UEJF","Valley Hill",2175,1063,1112,2173,3,25
"33UEJG","Walpole",2176,1061,1115,2176,0,16
"33UEJH","Walton",2544,1275,1269,2527,17,27
"33UEJJ","Watlington",2031,990,1041,2031,0,25
"33UEJK","West Winch",4631,2231,2400,4598,33,65
"33UEJL","Wiggenhall",1842,929,913,1823,19,18
"33UEJM","Wimbotsham with Fincham",2287,1130,1157,2286,0,46
"33UEJN","Wissey",2127,1067,1060,2114,13,16
"33UFGP","Astley",2103,1026,1077,2044,59,42
"33UFGQ","Briston",2021,988,1033,2021,0,19
"33UFGR","Chaucer",2347,1170,1177,2228,119,30
"33UFGS","Corpusty",2241,1089,1152,2241,0,30
"33UFGT","Cromer Town",3882,1802,2080,3612,270,17
"33UFGU","Erpingham",2242,1100,1142,2242,0,37
"33UFGW","Gaunt",2189,1103,1086,2163,26,19
"33UFGX","Glaven Valley",2159,1011,1148,2104,55,44
"33UFGY","Happisburgh",2290,1128,1162,2259,31,27
"33UFGZ","High Heath",1780,833,947,1720,60,19
"33UFHA","Holt",3550,1669,1881,3216,334,41
"33UFHB","Hoveton",2001,957,1044,2000,0,17
"33UFHC","Lancaster North",3384,1622,1762,3361,23,28
"33UFHD","Lancaster South",3973,1892,2081,3886,87,26
"33UFHE","Mundesley",4090,1951,2139,4004,86,34
"33UFHF","North Walsham East",4144,1953,2191,4112,32,35
"33UFHG","North Walsham North",4067,1937,2130,4009,58,26
"33UFHH","North Walsham West",3787,1804,1983,3625,162,26
"33UFHJ","Poppyland",2244,1076,1168,2173,71,20
"33UFHK","Priory",4206,2024,2182,4168,38,56
"33UFHL","Roughton",2090,1010,1080,2090,0,38
"33UFHM","Scottow",3221,1843,1378,2582,639,30
"33UFHN","St Benet",2050,962,1088,2022,28,35
"33UFHP","Sheringham North",3612,1633,1979,3413,199,29
"33UFHQ","Sheringham South",3531,1651,1880,3510,21,49
"33UFHR","Stalham and Sutton",4177,2007,2170,4117,60,30
"33UFHS","Suffield Park",3867,1808,2059,3755,112,26
"33UFHT","The Raynhams",2237,1133,1104,2236,0,21
"33UFHU","The Runtons",2068,979,1089,2031,37,19
"33UFHW","Walsingham",2232,1084,1148,2180,52,26
"33UFHX","Waterside",4016,1953,2063,3921,95,45
"33UFHY","Waxham",2011,1016,995,1987,24,23
"33UFHZ","Wensum",2298,1117,1181,2275,23,38
"33UFJA","Worstead",2272,1139,1133,2212,60,35
"33UGFS","Bowthorpe",9672,4646,5026,9601,71,34
"33UGFT","Catton Grove",9148,4464,4684,9087,61,43
"33UGFU","Crome",9894,4911,4983,9619,275,33
"33UGFW","Eaton",9009,4240,4769,8876,133,201
"33UGFX","Lakenham",9412,4429,4983,9371,41,48
"33UGFY","Mancroft",8339,4176,4163,8094,245,35
"33UGFZ","Mile Cross",9810,4819,4991,9752,58,20
"33UGGA","Nelson",9294,4470,4824,9168,126,127
"33UGGB","Sewell",9735,4839,4896,9621,114,36
"33UGGC","Thorpe Hamlet",8109,3990,4119,7804,305,50
"33UGGD","Town Close",9592,4491,5101,9250,342,113
"33UGGE","University",9007,4236,4771,6351,2656,47
"33UGGF","Wensum",10529,5119,5410,10509,20,46
"33UHGU","Abbey",2784,1335,1449,2764,20,17
"33UHGW","Beck Vale",2186,1074,1112,2178,8,30
"33UHGX","Bressingham and Burston",2543,1297,1246,2485,58,41
"33UHGY","Brooke",2480,1202,1278,2458,22,53
"33UHGZ","Bunwell",2481,1230,1251,2470,11,36
"33UHHA","Chedgrave and Thurton",2611,1300,1311,2467,144,30
"33UHHB","Cringleford",3948,1873,2075,3898,50,103
"33UHHC","Cromwells",2256,1109,1147,2256,0,36
"33UHHD","Dickleburgh",2623,1301,1322,2600,23,36
"33UHHE","Diss",6742,3150,3592,6648,94,47
"33UHHF","Ditchingham and Broome",2373,1147,1226,2327,46,44
"33UHHG","Earsham",2450,1184,1266,2419,31,32
"33UHHH","Easton",2291,1112,1179,2233,58,25
"33UHHJ","Forncett",2455,1192,1263,2415,40,34
"33UHHK","Gillingham",2793,1358,1435,2757,36,43
"33UHHL","Harleston",4058,1952,2106,4036,22,39
"33UHHM","Hempnall",2534,1273,1261,2511,23,39
"33UHHN","Hethersett",5441,2570,2871,5354,87,85
"33UHHP","Hingham and Deopham",2583,1273,1310,2555,28,35
"33UHHQ","Loddon",2622,1251,1371,2612,10,21
"33UHHR","Mulbarton",4340,2099,2241,4283,57,61
"33UHHS","New Costessey",5211,2564,2647,5185,26,29
"33UHHT","Newton Flotman",2327,1120,1207,2278,49,32
"33UHHU","Northfields",2806,1340,1466,2780,26,23
"33UHHW","Old Costessey",4611,2292,2319,4605,6,35
"33UHHX","Poringland with the Framinghams",4262,2017,2245,4236,26,50
"33UHHY","Rockland",2741,1358,1383,2702,39,42
"33UHHZ","Roydon",2298,1162,1136,2298,0,24
"33UHJA","Rustens",2115,1010,1105,2073,42,32
"33UHJB","Scole",2254,1101,1153,2222,32,13
"33UHJC","Stoke Holy Cross",2461,1192,1269,2456,5,43
"33UHJD","Stratton",4619,2264,2355,4566,53,58
"33UHJE","Tasburgh",2285,1119,1166,2251,34,38
"33UHJF","Thurlton",2651,1340,1311,2651,0,39
"33UHJG","Town",2578,1243,1335,2575,3,29
"33UHJH","Wicklewood",2897,1449,1448,2353,544,56
"34UBFN","Central",5413,2623,2790,5386,27,32
"34UBFP","Danesholme",6194,3032,3162,6184,10,72
"34UBFQ","East",3433,1721,1712,3274,159,12
"34UBFR","Hazelwood",5621,2718,2903,5609,12,19
"34UBFS","Hillside",2345,1143,1202,2345,0,13
"34UBFT","Kingswood",5622,2766,2856,5589,33,23
"34UBFU","Lloyds",6334,3000,3334,6334,0,26
"34UBFW","Lodge Park",5430,2637,2793,5428,3,36
"34UBFX","Rural East",2517,1266,1251,2500,17,31
"34UBFY","Rural North",1355,670,685,1326,29,23
"34UBFZ","Rural West",1510,724,786,1473,37,22
"34UBGA","Shire Lodge",3941,1891,2050,3900,41,29
"34UBGB","West",3459,1696,1763,3450,9,26
"34UCGD","Abbey North",6794,3368,3426,6793,3,39
"34UCGE","Abbey South",3499,1732,1767,3359,140,30
"34UCGF","Badby",1977,982,995,1972,5,48
"34UCGG","Barby and Kilsby",4104,2400,1704,3343,761,68
"34UCGH","Boughton and Pitsford",1587,767,820,1586,0,38
"34UCGJ","Brampton",1647,832,815,1647,0,37
"34UCGK","Braunston",1675,820,855,1675,0,27
"34UCGL","Brixworth",6033,2984,3049,5869,164,98
"34UCGM","Byfield",1794,888,906,1763,31,44
"34UCGN","Clipston",1841,925,916,1813,28,41
"34UCGP","Crick",1545,763,782,1544,3,34
"34UCGQ","Drayton",6415,3258,3157,6388,27,66
"34UCGR","Flore",1911,938,973,1885,26,34
"34UCGS","Hill",5023,2500,2523,5021,3,41
"34UCGT","Long Buckby",4224,2056,2168,4211,13,69
"34UCGU","Moulton",4047,1936,2111,3894,153,55
"34UCGW","Ravensthorpe",1760,861,899,1760,0,71
"34UCGX","Spratton",1731,849,882,1728,3,40
"34UCGY","Walgrave",1736,853,883,1736,0,43
"34UCGZ","Weedon",3072,1543,1529,3059,13,63
"34UCHA","Welford",1876,946,930,1847,29,39
"34UCHB","West Haddon and Guilsborough",2099,1042,1057,2072,27,48
"34UCHC","Woodford",3694,1840,1854,3672,22,31
"34UCHD","Yelvertoft",1754,884,870,1738,16,28
"34UDFX","Barnwell",1952,953,999,1902,50,40
"34UDFY","Dryden",1805,890,915,1780,25,34
"34UDFZ","Fineshade",1633,796,837,1633,0,23
"34UDGA","Higham Ferrers",6689,3294,3395,6607,82,66
"34UDGB","Irthlingborough",7033,3489,3544,6951,82,37
"34UDGC","King's Forest",1893,937,956,1851,42,33
"34UDGD","Lower Nene",1932,964,968,1932,0,57
"34UDGE","Lyveden",1826,885,941,1826,0,30
"34UDGF","Oundle",5345,2733,2612,4497,848,168
"34UDGG","Prebendal",1741,858,883,1741,0,41
"34UDGH","Raunds Saxon",4307,2132,2175,4268,39,42
"34UDGJ","Raunds Windmill",3968,1954,2014,3900,68,31
"34UDGK","Ringstead",1678,847,831,1659,19,23
"34UDGL","Rushden East",6306,3081,3225,6161,145,29
"34UDGM","Rushden North",6112,3033,3079,6034,78,33
"34UDGN","Rushden South",6706,3329,3377,6612,94,59
"34UDGP","Rushden West",6725,3294,3431,6724,3,31
"34UDGQ","Stanwick",2160,1096,1064,2126,34,15
"34UDGR","Thrapston",4855,2406,2449,4837,18,41
"34UDGS","Woodford",1884,947,937,1861,23,20
"34UEFZ","All Saints",3492,1701,1791,3436,56,56
"34UEGA","Avondale",4220,2030,2190,4220,0,11
"34UEGB","Barton",4185,2029,2156,4138,47,27
"34UEGC","Brambleside",4023,2007,2016,4000,23,50
"34UEGD","Buccleuch",1385,677,708,1312,73,52
"34UEGE","Latimer",3342,1596,1746,3310,32,22
"34UEGF","Loatland",4281,2143,2138,4188,93,33
"34UEGG","Millbrook",3897,1916,1981,3837,60,51
"34UEGH","Pipers Hill",2790,1302,1488,2771,19,31
"34UEGJ","Plessy",3398,1645,1753,3398,0,25
"34UEGK","Queen Eleanor",1651,793,858,1651,0,29
"34UEGL","St Andrew's",5144,2637,2507,5094,50,38
"34UEGM","St Giles",3792,1908,1884,3749,43,45
"34UEGN","St Mary's",5144,2534,2610,5050,94,30
"34UEGP","St Michael's",3309,1560,1749,3192,117,43
"34UEGQ","St Peter's",3839,1882,1957,3735,104,51
"34UEGR","Slade",3675,1811,1864,3652,23,79
"34UEGS","Spinney",4056,2031,2025,4056,0,81
"34UEGT","Tresham",3615,1772,1843,3604,11,34
"34UEGU","Trinity",3493,1712,1781,3491,3,40
"34UEGW","Warkton",3540,1719,1821,3540,0,18
"34UEGX","Welland",2149,1083,1066,2149,0,49
"34UEGY","Wicksteed",3424,1649,1775,3378,46,18
"34UFFY","Abington",8244,4183,4061,8119,125,52
"34UFFZ","Billing",8695,4233,4462,8693,0,80
"34UFGA","Boughton Green",10720,5274,5446,10592,128,104
"34UFGB","Castle",9068,4790,4278,8866,202,30
"34UFGC","Delapre",8273,4122,4151,8263,10,19
"34UFGD","East Hunsbury",9058,4561,4497,9054,4,76
"34UFGE","Eastfield",9118,4344,4774,9026,92,76
"34UFGF","Ecton Brook",7748,3741,4007,7727,21,71
"34UFGG","Headlands",8196,3922,4274,8147,49,105
"34UFGH","Kingsley",9968,4683,5285,8514,1454,56
"34UFGJ","Kingsthorpe",7340,3543,3797,7247,93,79
"34UFGK","Lumbertubs",8907,4307,4600,8876,31,67
"34UFGL","Nene Valley",9055,4424,4631,8981,74,89
"34UFGM","New Duston",8254,4128,4126,8248,6,72
"34UFGN","Old Duston",8010,3841,4169,7919,91,61
"34UFGP","Parklands",7484,3672,3812,7422,62,60
"34UFGQ","St Crispin",8433,4302,4131,8151,282,53
"34UFGR","St David",6157,2865,3292,6007,150,25
"34UFGS","St James",8550,4179,4371,8332,218,36
"34UFGT","Spencer",8545,4077,4468,8432,113,46
"34UFGU","Thorplands",8093,3943,4150,8029,64,36
"34UFGW","West Hunsbury",7468,3727,3741,7381,87,97
"34UFGX","Weston",9074,4519,4555,8690,384,189
"34UGGK","Astwell",2012,1018,994,1983,29,52
"34UGGL","Blakesley",1634,821,813,1634,0,64
"34UGGM","Blisworth",1786,880,906,1786,0,28
"34UGGN","Brackley East",4460,2251,2209,4379,81,65
"34UGGP","Brackley South",3963,1955,2008,3859,104,37
"34UGGQ","Brackley West",4908,2508,2400,4908,0,44
"34UGGR","Chase",3242,1569,1673,3221,21,51
"34UGGS","Cogenhoe",1439,696,743,1436,3,36
"34UGGT","Cosgrove",2024,1015,1009,2024,0,23
"34UGGU","Cote",1871,943,928,1835,36,39
"34UGGW","Courteenhall",3382,1665,1717,3357,25,35
"34UGGX","Deanshanger",3199,1571,1628,3199,0,32
"34UGGY","Downs",3285,1636,1649,3246,39,48
"34UGGZ","Grafton",1966,1014,952,1916,50,33
"34UGHA","Grange",1721,828,893,1715,6,27
"34UGHB","Harpole",1547,755,792,1547,0,17
"34UGHC","Heyford",1584,797,787,1551,33,34
"34UGHD","Kings Sutton",2069,1013,1056,2069,0,23
"34UGHE","Kingthorn",1766,857,909,1730,36,47
"34UGHF","Little Brook",2169,1100,1069,2081,88,44
"34UGHG","Middleton Cheney",4026,1986,2040,4006,20,33
"34UGHH","Salcey",1815,923,892,1815,0,19
"34UGHJ","Silverstone",1989,1012,977,1970,19,28
"34UGHK","Steane",1859,910,949,1859,0,52
"34UGHL","Tove",1656,824,832,1656,0,39
"34UGHM","Towcester Brook",4632,2308,2324,4599,33,93
"34UGHN","Towcester Mill",4298,2109,2189,4293,5,45
"34UGHP","Wardoun",3666,1866,1800,3620,46,94
"34UGHQ","Washington",1655,832,823,1655,0,58
"34UGHR","Whittlewood",1977,1022,955,1976,0,27
"34UGHS","Yardley",1693,810,883,1689,4,39
"34UHFR","Brickhill",5902,2838,3064,5843,59,56
"34UHFS","Castle",6497,3322,3175,6380,117,55
"34UHFT","Croyland",7608,3911,3697,7170,438,37
"34UHFU","Earls Barton",5353,2605,2748,5320,33,66
"34UHFW","Finedon",4188,2116,2072,4186,0,26
"34UHFX","Great Doddington and Wilby",1682,818,864,1682,0,18
"34UHFY","Hemmingwell",6823,3356,3467,6785,38,43
"34UHFZ","Irchester",4807,2397,2410,4751,56,27
"34UHGA","North",2163,1055,1108,2163,0,34
"34UHGB","Queensway",6351,3052,3299,6335,16,19
"34UHGC","Redwell East",4544,2296,2248,4539,5,86
"34UHGD","Redwell West",3630,1862,1768,3630,0,51
"34UHGE","South",2029,1025,1004,2012,17,19
"34UHGF","Swanspool",5703,2731,2972,5596,107,47
"34UHGG","West",1692,836,856,1692,0,20
"34UHGH","Wollaston",3547,1741,1806,3547,0,46
"35UBFT","Alnmouth and Lesbury",1699,823,876,1682,17,48
"35UBFU","Alnwick Castle",3387,1587,1800,3261,126,56
"35UBFW","Alnwick Clayport",2215,1039,1176,2181,34,9
"35UBFX","Alnwick Hotspur",2165,1029,1136,2140,25,40
"35UBFY","Amble Central",2223,1088,1135,2186,37,19
"35UBFZ","Amble East",2304,1119,1185,2304,0,15
"35UBGA","Amble West",2077,1038,1039,2077,0,17
"35UBGB","Embleton",941,465,476,941,0,18
"35UBGC","Harbottle and Elsdon",932,467,465,919,13,18
"35UBGD","Hedgeley",875,432,443,847,28,25
"35UBGE","Longframlington",1179,575,604,1179,0,17
"35UBGF","Longhoughton with Craster and Rennington",2089,1072,1017,1939,150,35
"35UBGG","Rothbury and South Rural",2880,1377,1503,2847,33,61
"35UBGH","Shilbottle",3129,1519,1610,3129,0,37
"35UBGJ","Warkworth",1960,928,1032,1931,29,54
"35UBGK","Whittingham",974,494,480,974,0,26
"35UCFS","Bamburgh",788,382,406,774,14,16
"35UCFT","Beadnell",810,388,422,810,0,7
"35UCFU","Belford",1055,515,540,1052,3,16
"35UCFW","Cheviot",934,480,454,934,0,28
"35UCFX","Edward",1743,835,908,1693,50,17
"35UCFY","Elizabeth",2462,1162,1300,2384,78,34
"35UCFZ","Flodden",789,399,390,778,11,26
"35UCGA","Ford",948,471,477,948,0,14
"35UCGB","Islandshire",2735,1362,1373,2732,3,40
"35UCGC","Lowick",989,481,508,989,0,11
"35UCGD","Norhamshire",1573,770,803,1517,56,41
"35UCGE","North Sunderland",1803,853,950,1789,14,14
"35UCGF","Prior",1946,907,1039,1874,72,3
"35UCGG","Seton",1666,767,899,1581,85,13
"35UCGH","Shielfield",786,390,396,786,0,18
"35UCGJ","Spittal",3065,1449,1616,3044,21,20
"35UCGK","Wooler",1857,859,998,1841,16,10
"35UDGN","Cowpen",4807,2322,2485,4699,108,10
"35UDGP","Cramlington East",5408,2565,2843,5280,128,18
"35UDGQ","Cramlington Eastfield with East Hartford",3877,1852,2025,3877,0,30
"35UDGR","Cramlington North",5606,2818,2788,5606,0,67
"35UDGS","Cramlington Parkside",3355,1651,1704,3291,64,48
"35UDGT","Cramlington South East",4152,2078,2074,4152,0,42
"35UDGU","Cramlington Village",4385,2104,2281,4307,78,51
"35UDGW","Cramlington West",3615,1723,1892,3562,53,10
"35UDGX","Croft",4867,2339,2528,4771,96,14
"35UDGY","Hartley",4772,2264,2508,4737,35,38
"35UDGZ","Holywell",2979,1417,1562,2939,40,23
"35UDHA","Isabella",3293,1615,1678,3293,0,10
"35UDHB","Kitty Brewster",3476,1689,1787,3362,114,11
"35UDHC","Newsham and New Delaval",4588,2266,2322,4576,12,25
"35UDHD","Plessey",5235,2506,2729,5210,25,18
"35UDHE","Seaton Delaval",4371,2180,2191,4357,14,16
"35UDHF","Seghill",2927,1473,1454,2927,0,18
"35UDHG","South Beach",3451,1728,1723,3451,0,23
"35UDHH","South Newsham",2812,1403,1409,2812,0,28
"35UDHJ","Wensleydale",3289,1577,1712,3245,44,24
"35UEFY","Chevington",3223,2011,1212,2356,867,16
"35UEFZ","Ellington",2915,1445,1470,2907,8,28
"35UEGA","Hartburn",1589,787,802,1589,0,44
"35UEGB","Hebron, Hepscott and Mitford",2008,1041,967,1712,296,45
"35UEGC","Heddon-on-the-Wall",1518,752,766,1518,0,18
"35UEGD","Longhorsley",1495,741,754,1488,7,29
"35UEGE","Lynemouth",1832,891,941,1820,12,8
"35UEGF","Morpeth Central",2810,1303,1507,2757,53,36
"35UEGG","Morpeth Kirkhill",2534,1197,1337,2529,5,72
"35UEGH","Morpeth North",2794,1370,1424,2528,266,102
"35UEGJ","Morpeth South",2654,1275,1379,2654,0,43
"35UEGK","Morpeth Stobhill",3041,1483,1558,3041,0,38
"35UEGL","Pegswood",3620,1725,1895,3493,127,23
"35UEGM","Ponteland East",2837,1334,1503,2830,7,62
"35UEGN","Ponteland North",2599,1214,1385,2484,115,38
"35UEGP","Ponteland South",2727,1361,1366,2727,0,82
"35UEGQ","Ponteland West",2708,1347,1361,2708,0,90
"35UEGR","Stamfordham",1542,844,698,1410,132,37
"35UEGS","Stannington",1646,815,831,1629,17,36
"35UEGT","Ulgham",2909,1421,1488,2872,37,23
"35UFGK","Acomb",1184,577,607,1184,0,18
"35UFGL","Allendale",2402,1172,1230,2335,67,40
"35UFGM","Bellingham",1227,608,619,1225,3,15
"35UFGN","Broomhaugh and Riding",936,445,491,909,27,31
"35UFGP","Chollerton with Whittington",1218,618,600,1218,0,28
"35UFGQ","Corbridge",3006,1383,1623,2940,66,75
"35UFGR","East Tynedale",1393,668,725,1234,159,39
"35UFGS","Hadrian",2141,1103,1038,2121,20,37
"35UFGT","Haltwhistle",3811,1852,1959,3764,47,38
"35UFGU","Haydon",2027,979,1048,1979,48,36
"35UFGW","Hexham Gilesgate",979,466,513,979,0,10
"35UFGX","Hexham Hencotes",3475,1651,1824,3432,43,75
"35UFGY","Hexham Leazes",3431,1663,1768,3370,61,116
"35UFGZ","Hexham Priestpopple",3561,1686,1875,3446,115,59
"35UFHA","Humshaugh and Wall",1046,510,536,1031,15,22
"35UFHB","Ovingham",1144,528,616,1144,0,23
"35UFHC","Prudhoe Castle",2305,1132,1173,2305,0,24
"35UFHD","Prudhoe North",2108,992,1116,2087,21,6
"35UFHE","Prudhoe South",3385,1624,1761,3229,156,23
"35UFHF","Prudhoe West",2470,1202,1268,2455,15,26
"35UFHG","Redesdale",908,467,441,887,21,26
"35UFHH","Sandhoe with Dilston",1023,504,519,950,73,55
"35UFHJ","Slaley and Hexhamshire",1435,722,713,1384,51,39
"35UFHK","South Tynedale",1130,570,560,1119,11,16
"35UFHL","Stocksfield with Mickley",3857,1922,1935,3838,19,118
"35UFHM","Upper North Tyne",744,370,374,725,19,14
"35UFHN","Wanney",974,491,483,970,4,26
"35UFHP","Warden and Newbrough",1146,558,588,1146,0,32
"35UFHQ","Wark",1140,583,557,1140,0,22
"35UFHR","West Tynedale",1115,586,529,1115,0,10
"35UFHS","Wylam",2087,1009,1078,2054,33,43
"35UGFS","Bedlington Central",4325,2087,2238,4189,136,35
"35UGFT","Bedlington East",4462,2149,2313,4397,65,14
"35UGFU","Bedlington West",5360,2660,2700,5346,14,36
"35UGFW","Bothal",4115,2042,2073,4098,17,39
"35UGFX","Central",3907,1890,2017,3867,40,11
"35UGFY","Choppington",2891,1432,1459,2882,9,9
"35UGFZ","College",3650,1792,1858,3650,0,22
"35UGGA","Guide Post",3614,1765,1849,3614,0,21
"35UGGB","Haydon",4780,2374,2406,4744,36,28
"35UGGC","Hirst",3366,1633,1733,3291,75,8
"35UGGD","Newbiggin East",3299,1572,1727,3288,11,14
"35UGGE","Newbiggin West",2658,1264,1394,2643,15,18
"35UGGF","Park",3737,1812,1925,3737,0,6
"35UGGG","Seaton",3904,1938,1966,3904,0,45
"35UGGH","Sleekburn",4065,2009,2056,4020,45,16
"35UGGJ","Stakeford",3005,1444,1561,3005,0,15
"36UBGB","Aire Valley with Lothersdale",3475,1680,1795,3431,44,56
"36UBGC","Barden Fell",1695,830,865,1641,54,38
"36UBGD","Bentham",3573,1717,1856,3490,83,53
"36UBGE","Cowling",2096,1034,1062,2078,18,14
"36UBGF","Embsay-with-Eastby",1758,816,942,1758,0,30
"36UBGG","Gargrave and Malhamdale",3042,1451,1591,2883,159,43
"36UBGH","Glusburn",3902,1848,2054,3803,99,43
"36UBGJ","Grassington",1584,744,840,1583,0,32
"36UBGK","Hellifield and Long Preston",1781,871,910,1760,21,26
"36UBGL","Ingleton and Clapham",3725,1796,1929,3656,69,61
"36UBGM","Penyghent",2148,1117,1031,1830,318,36
"36UBGN","Settle and Ribblebanks",3390,1605,1785,3288,102,53
"36UBGP","Skipton East",3474,1642,1832,3472,3,44
"36UBGQ","Skipton North",3308,1572,1736,3289,19,71
"36UBGR","Skipton South",3797,1753,2044,3797,0,20
"36UBGS","Skipton West",3734,1799,1935,3672,62,25
"36UBGT","Sutton-in-Craven",3480,1700,1780,3376,104,41
"36UBGU","Upper Wharfedale",1895,914,981,1813,82,35
"36UBGW","West Craven",1763,902,861,1721,42,27
"36UCGM","Bedale",4438,2118,2320,4323,115,44
"36UCGN","Brompton",1912,925,987,1912,0,32
"36UCGP","Broughton and Greenhow",1646,808,838,1646,0,34
"36UCGQ","Cowtons",1714,865,849,1714,0,52
"36UCGR","Crakehall",1680,825,855,1678,3,36
"36UCGS","Easingwold",4233,2021,2212,4142,91,75
"36UCGT","Great Ayton",4930,2370,2560,4930,0,91
"36UCGU","Helperby",1838,943,895,1830,8,29
"36UCGW","Huby and Sutton",1905,965,940,1905,0,37
"36UCGX","Leeming",2918,1653,1265,2486,432,40
"36UCGY","Leeming Bar",1773,850,923,1730,43,45
"36UCGZ","Morton-on-Swale",1722,843,879,1721,3,46
"36UCHA","Northallerton Broomfield",3943,1879,2064,3822,121,74
"36UCHB","Northallerton Central",4358,2118,2240,4302,56,34
"36UCHC","Northallerton North",3640,1717,1923,3622,18,41
"36UCHD","Osmotherley",1713,868,845,1713,0,28
"36UCHE","Romanby",3800,1824,1976,3794,6,60
"36UCHF","Rudby",3453,1725,1728,3449,4,100
"36UCHG","Shipton",2529,1299,1230,2291,238,39
"36UCHH","Sowerby",3695,1785,1910,3561,134,48
"36UCHJ","Stillington",1819,896,923,1819,0,46
"36UCHK","Stokesley",5530,2674,2856,5476,54,107
"36UCHL","Swainby",1753,870,883,1753,0,50
"36UCHM","Tanfield",1755,873,882,1755,0,35
"36UCHN","Thirsk",5629,2791,2838,5616,13,41
"36UCHP","Thorntons",1808,899,909,1770,38,52
"36UCHQ","Tollerton",1761,883,878,1691,70,31
"36UCHR","Topcliffe",2443,1344,1099,2227,216,35
"36UCHS","White Horse",1928,955,973,1923,5,34
"36UCHT","Whitestonecliffe",1845,884,961,1839,6,56
"36UDGL","Bilton",5653,2758,2895,5653,0,75
"36UDGM","Bishop Monkton",2730,1337,1393,2726,4,55
"36UDGN","Boroughbridge",2878,1364,1514,2827,51,32
"36UDGP","Claro",3037,1469,1568,3033,4,58
"36UDGQ","Granby",6115,2926,3189,5946,169,60
"36UDGR","Harlow Moor",5527,2400,3127,4779,748,110
"36UDGS","High Harrogate",5425,2602,2823,5342,83,60
"36UDGT","Hookstone",5728,2721,3007,5628,100,69
"36UDGU","Killinghall",4013,2506,1507,2795,1218,56
"36UDGW","Kirkby Malzeard",2898,1440,1458,2862,36,71
"36UDGX","Knaresborough East",4913,2311,2602,4879,34,64
"36UDGY","Knaresborough King James",4932,2390,2542,4867,65,87
"36UDGZ","Knaresborough Scriven Park",5117,2498,2619,5052,65,81
"36UDHA","Low Harrogate",5302,2419,2883,5086,216,61
"36UDHB","Lower Nidderdale",3081,1518,1563,3081,0,69
"36UDHC","Marston Moor",2946,1449,1497,2917,29,57
"36UDHD","Mashamshire",2384,1128,1256,2375,9,40
"36UDHE","Newby",2923,1436,1487,2891,32,74
"36UDHF","New Park",5340,2616,2724,5340,0,49
"36UDHG","Nidd Valley",3172,1579,1593,3065,107,55
"36UDHH","Ouseburn",2997,1402,1595,2777,220,53
"36UDHJ","Pannal",5545,2679,2866,5523,22,171
"36UDHK","Pateley Bridge",2598,1262,1336,2581,17,35
"36UDHL","Ribston",2865,1359,1506,2756,109,67
"36UDHM","Ripon Minster",4907,2332,2575,4828,79,52
"36UDHN","Ripon Moorside",5305,2599,2706,5157,148,49
"36UDHP","Ripon Spa",5710,2752,2958,4939,771,95
"36UDHQ","Rossett",5766,2777,2989,5558,208,138
"36UDHR","Saltergate",6098,2936,3162,6098,0,63
"36UDHS","Spofforth with Lower Wharfedale",3053,1476,1577,3009,44,55
"36UDHT","Starbeck",5729,2757,2972,5624,105,38
"36UDHU","Stray",5452,2542,2910,5217,235,149
"36UDHW","Washburn",2888,1446,1442,2888,0,98
"36UDHX","Wathvale",3010,1542,1468,2818,192,55
"36UDHY","Woodfield",5299,2455,2844,5269,30,38
"36UEGD","Addlebrough",1279,632,647,1228,51,25
"36UEGE","Barton",1272,601,671,1272,0,23
"36UEGF","Bolton Castle",1202,592,610,1202,0,28
"36UEGG","Brompton-on-Swale and Scorton",2851,1404,1447,2778,73,53
"36UEGH","Catterick",2743,1442,1301,2392,351,31
"36UEGJ","Colburn",3606,1754,1852,3507,99,31
"36UEGK","Croft",1295,657,638,1290,5,31
"36UEGL","Gilling West",1203,591,612,1203,0,27
"36UEGM","Hawes and High Abbotside",1323,657,666,1305,18,15
"36UEGN","Hipswell",4562,2744,1818,3496,1066,72
"36UEGP","Hornby Castle",1211,591,620,1209,3,22
"36UEGQ","Leyburn",2208,1027,1181,2150,58,29
"36UEGR","Lower Wensleydale",1339,723,616,1263,76,22
"36UEGS","Melsonby",1323,652,671,1323,0,24
"36UEGT","Middleham",1304,640,664,1290,14,29
"36UEGU","Middleton Tyas",1206,593,613,1157,49,28
"36UEGW","Newsham with Eppleby",1197,605,592,1197,0,28
"36UEGX","Penhill",1138,556,582,1138,0,29
"36UEGY","Reeth and Arkengarthdale",1132,543,589,1122,10,23
"36UEGZ","Richmond Central",2756,1281,1475,2694,62,47
"36UEHA","Richmond East",2741,1302,1439,2741,0,55
"36UEHB","Richmond West",2681,1291,1390,2643,38,42
"36UEHC","Scotton",4322,2836,1486,2843,1479,39
"36UEHD","Swaledale",1116,554,562,1099,17,16
"36UFGF","Amotherby",1809,896,913,1805,4,32
"36UFGG","Ampleforth",2048,1292,756,1467,581,43
"36UFGH","Cropton",1502,758,744,1495,7,25
"36UFGJ","Dales",1583,805,778,1553,30,31
"36UFGK","Derwent",3408,1694,1714,3357,51,69
"36UFGL","Helmsley",3111,1499,1612,3053,58,63
"36UFGM","Hovingham",1777,874,903,1720,57,38
"36UFGN","Kirkbymoorside",3283,1569,1714,3281,0,60
"36UFGP","Malton",5023,2454,2569,4907,116,72
"36UFGQ","Norton East",3441,1653,1788,3347,94,20
"36UFGR","Norton West",3502,1735,1767,3428,74,44
"36UFGS","Pickering East",3335,1558,1777,3274,61,46
"36UFGT","Pickering West",3511,1655,1856,3467,44,35
"36UFGU","Rillington",1734,874,860,1734,0,18
"36UFGW","Ryedale South West",1628,803,825,1590,38,47
"36UFGX","Sherburn",1882,955,927,1882,0,20
"36UFGY","Sheriff Hutton",1703,839,864,1703,0,55
"36UFGZ","Sinnington",1683,838,845,1683,0,43
"36UFHA","Thornton Dale",3311,1595,1716,3228,83,69
"36UFHB","Wolds",1598,821,777,1596,3,23
"36UGFZ","Castle",4112,1977,2135,4008,104,26
"36UGGA","Cayton",4161,2011,2150,4153,8,43
"36UGGB","Central",4697,2254,2443,4692,5,17
"36UGGC","Danby",2219,1099,1120,1911,308,62
"36UGGD","Derwent Valley",4529,2180,2349,4471,58,99
"36UGGE","Eastfield",5863,2737,3126,5823,40,16
"36UGGF","Esk Valley",4217,1983,2234,4178,39,93
"36UGGG","Falsgrave Park",4031,1927,2104,4006,25,47
"36UGGH","Filey",6468,2950,3518,6337,131,50
"36UGGJ","Fylingdales",2252,1083,1169,2049,203,50
"36UGGK","Hertford",4803,2298,2505,4728,75,54
"36UGGL","Lindhead",2100,990,1110,2093,7,27
"36UGGM","Mayfield",4565,2126,2439,4514,51,69
"36UGGN","Mulgrave",3706,1821,1885,3695,11,60
"36UGGP","Newby",6551,3131,3420,6475,76,83
"36UGGQ","North Bay",4268,2079,2189,4205,63,27
"36UGGR","Northstead",4071,1887,2184,3946,125,43
"36UGGS","Ramshill",3985,1844,2141,3598,387,20
"36UGGT","Scalby, Hackness and Staintondale",3953,1879,2074,3948,5,100
"36UGGU","Seamer",4106,2015,2091,4093,13,52
"36UGGW","Stepney",4237,1962,2275,4055,182,50
"36UGGX","Streonshalh",4863,2380,2483,4824,39,35
"36UGGY","Weaponness",3725,1656,2069,3164,561,61
"36UGGZ","Whitby West Cliff",4166,1972,2194,3908,258,63
"36UGHA","Woodlands",4595,2133,2462,4555,40,40
"36UHGN","Appleton Roebuck",1762,886,876,1762,0,46
"36UHGP","Barlby",3852,1900,1952,3833,19,21
"36UHGQ","Brayton",5514,2709,2805,5499,15,91
"36UHGR","Camblesforth",4052,2030,2022,4009,43,45
"36UHGS","Cawood with Wistow",3789,1859,1930,3789,0,45
"36UHGT","Eggborough",3370,1658,1712,3314,56,33
"36UHGU","Fairburn with Brotherton",3451,1713,1738,3446,5,26
"36UHGW","Hambleton",5226,2565,2661,5186,40,70
"36UHGX","Hemingbrough",3571,1775,1796,3571,0,35
"36UHGY","Monk Fryston and South Milford",3432,1644,1788,3425,7,57
"36UHGZ","North Duffield",1771,869,902,1754,17,26
"36UHHA","Riccall with Escrick",4328,1951,2377,3882,446,59
"36UHHB","Saxton and Ulleskelf",2044,1038,1006,2002,42,33
"36UHHC","Selby North",5726,2786,2940,5673,53,22
"36UHHD","Selby South",3447,1687,1760,3410,37,11
"36UHHE","Selby West",3839,1824,2015,3720,119,42
"36UHHF","Sherburn in Elmet",6221,3031,3190,6189,32,59
"36UHHG","Tadcaster East",3830,1889,1941,3812,18,28
"36UHHH","Tadcaster West",3511,1751,1760,3482,29,37
"36UHHJ","Whitley",3732,1859,1873,3732,0,60
"37UBFR","Hucknall Central",6487,3145,3342,6393,94,22
"37UBFS","Hucknall East",6163,3048,3115,6049,114,30
"37UBFT","Hucknall North",6820,3330,3490,6746,74,44
"37UBFU","Hucknall West",10234,5049,5185,10190,44,55
"37UBFW","Jacksdale",3269,1612,1657,3246,23,11
"37UBFX","Kirkby in Ashfield Central",6215,3028,3187,6104,111,38
"37UBFY","Kirkby in Ashfield East",6361,3077,3284,6265,96,21
"37UBFZ","Kirkby in Ashfield West",7009,3405,3604,6984,25,50
"37UBGA","Selston",6248,3060,3188,6142,106,41
"37UBGB","Sutton in Ashfield Central",11257,5333,5924,10993,264,30
"37UBGC","Sutton in Ashfield East",11181,5441,5740,10919,262,49
"37UBGD","Sutton in Ashfield North",10594,5235,5359,10508,86,60
"37UBGE","Sutton in Ashfield West",9899,4875,5024,9849,50,60
"37UBGF","Underwood",2955,1460,1495,2955,0,30
"37UBGG","Woodhouse",6695,3271,3424,6653,42,45
"37UCGE","Beckingham",2159,1063,1096,2146,13,32
"37UCGF","Blyth",2213,1067,1146,2138,75,30
"37UCGG","Carlton",5840,2807,3033,5804,36,64
"37UCGH","Clayworth",1905,949,956,1905,0,43
"37UCGJ","East Markham",2387,1206,1181,2238,149,48
"37UCGK","East Retford East",6931,3334,3597,6794,137,76
"37UCGL","East Retford North",5909,2848,3061,5811,98,50
"37UCGM","East Retford South",4328,2108,2220,4328,0,38
"37UCGN","East Retford West",4146,2044,2102,4098,48,52
"37UCGP","Everton",2177,1065,1112,2171,6,34
"37UCGQ","Harworth",7441,3578,3863,7374,67,29
"37UCGR","Langold",2533,1236,1297,2526,7,8
"37UCGS","Misterton",2318,1162,1156,2306,12,23
"37UCGT","Rampton",2394,1368,1026,1956,438,24
"37UCGU","Ranskill",2226,1105,1121,2142,84,32
"37UCGW","Sturton",2168,1088,1080,2168,0,38
"37UCGX","Sutton",2766,1726,1040,1917,849,40
"37UCGY","Tuxford and Trent",4041,2008,2033,4000,41,50
"37UCGZ","Welbeck",2319,1182,1137,2061,258,23
"37UCHA","Worksop East",6649,3201,3448,6571,78,48
"37UCHB","Worksop North",7696,3844,3852,7634,62,70
"37UCHC","Worksop North East",6422,3071,3351,6301,121,50
"37UCHD","Worksop North West",6906,3378,3528,6870,36,36
"37UCHE","Worksop South",6206,3031,3175,6113,93,89
"37UCHF","Worksop South East",7633,3721,3912,7449,184,13
"37UDFY","Attenborough",2283,1132,1151,2230,53,23
"37UDFZ","Awsworth",2266,1142,1124,2266,0,13
"37UDGA","Beeston Central",4752,2361,2391,4651,101,25
"37UDGB","Beeston North",5915,2877,3038,5915,0,56
"37UDGC","Beeston Rylands",5376,2694,2682,5277,99,29
"37UDGD","Beeston West",4966,2397,2569,4847,119,58
"37UDGE","Bramcote",7318,3651,3667,7297,21,169
"37UDGF","Brinsley",2352,1150,1202,2314,38,26
"37UDGG","Chilwell East",4815,2370,2445,4677,138,49
"37UDGH","Chilwell West",7915,3891,4024,7855,60,81
"37UDGJ","Cossall and Kimberley",6849,3341,3508,6821,28,38
"37UDGK","Eastwood North and Greasley (Beauvale)",3267,1621,1646,3267,0,21
"37UDGL","Eastwood South",9389,4556,4833,9202,187,35
"37UDGM","Greasley (Giltbrook and Newthorpe)",6076,2994,3082,6051,25,41
"37UDGN","Nuthall East and Strelley",4660,2346,2314,4659,0,63
"37UDGP","Nuthall West and Greasley (Watnall)",4514,2169,2345,4499,15,49
"37UDGQ","Stapleford North",4714,2320,2394,4697,17,19
"37UDGR","Stapleford South East",4969,2421,2548,4969,0,42
"37UDGS","Stapleford South West",5308,2611,2697,5308,0,19
"37UDGT","Toton and Chilwell Meadows",7298,3547,3751,7262,36,87
"37UDGU","Trowell",2568,1293,1275,2568,0,22
"37UEGB","Bestwood Village",1655,805,850,1584,71,6
"37UEGC","Bonington",6863,3273,3590,6783,80,58
"37UEGD","Burton Joyce and Stoke Bardolph",3555,1703,1852,3484,71,63
"37UEGE","Calverton",6903,3366,3537,6870,33,75
"37UEGF","Carlton",6911,3406,3505,6896,15,49
"37UEGG","Carlton Hill",7204,3537,3667,7177,27,40
"37UEGH","Daybrook",4997,2399,2598,4969,28,25
"37UEGJ","Gedling",6758,3254,3504,6541,217,50
"37UEGK","Killisick",2709,1233,1476,2648,61,10
"37UEGL","Kingswell",4699,2229,2470,4699,0,47
"37UEGM","Lambley",1977,979,998,1911,66,24
"37UEGN","Mapperley Plains",6885,3410,3475,6870,15,98
"37UEGP","Netherfield and Colwick",7042,3371,3671,7042,0,20
"37UEGQ","Newstead",2103,1034,1069,2086,17,24
"37UEGR","Phoenix",4962,2458,2504,4950,12,21
"37UEGS","Porchester",6806,3312,3494,6770,36,65
"37UEGT","Ravenshead",5636,2770,2866,5636,0,123
"37UEGU","St James",4476,2210,2266,4476,0,39
"37UEGW","St Marys",6801,3272,3529,6777,24,53
"37UEGX","Valley",4001,1909,2092,3965,36,13
"37UEGY","Woodborough",1852,910,942,1828,24,39
"37UEGZ","Woodthorpe",6992,3421,3571,6880,112,118
"37UFFU","Berry Hill",5980,2929,3051,5914,66,94
"37UFFW","Birklands",6092,2975,3117,6013,79,23
"37UFFX","Broomhill",4254,2054,2200,4160,94,23
"37UFFY","Cumberlands",4311,2068,2243,4311,0,11
"37UFFZ","Eakring",6412,3141,3271,6385,27,48
"37UFGA","Forest Town East",4761,2293,2468,4724,37,20
"37UFGB","Forest Town West",6433,3149,3284,6381,52,52
"37UFGC","Grange Farm",4453,2160,2293,4453,0,38
"37UFGD","Ladybrook",4439,2155,2284,4328,111,18
"37UFGE","Leeming",6430,3156,3274,6430,0,50
"37UFGF","Lindhurst",4171,2053,2118,4150,21,52
"37UFGG","Meden",6273,3070,3203,6273,0,26
"37UFGH","Oak Tree",6572,3194,3378,6553,19,47
"37UFGJ","Pleasley Hill",3971,1869,2102,3929,42,14
"37UFGK","Portland",4215,2064,2151,4135,80,38
"37UFGL","Priory",4432,2187,2245,4391,41,26
"37UFGM","Ravensdale",4114,1997,2117,4039,75,13
"37UFGN","Robin Hood",7069,3464,3605,7060,9,23
"37UFGP","Sherwood",3799,1791,2008,3656,143,29
"37UGGH","Balderton North",5437,2653,2784,5429,8,42
"37UGGJ","Balderton West",4639,2198,2441,4576,63,40
"37UGGK","Beacon",4539,2183,2356,4488,51,38
"37UGGL","Bilsthorpe",4954,2441,2513,4869,85,24
"37UGGM","Blidworth",4355,2111,2244,4314,41,21
"37UGGN","Boughton",5007,2410,2597,4939,68,33
"37UGGP","Bridge",5377,2623,2754,5304,73,24
"37UGGQ","Castle",5778,2810,2968,5737,41,44
"37UGGR","Caunton",2129,1045,1084,2129,0,44
"37UGGS","Clipstone",3469,1705,1764,3469,0,16
"37UGGT","Collingham and Meering",4472,2172,2300,4406,66,79
"37UGGU","Devon",5012,2367,2645,4986,26,14
"37UGGW","Edwinstowe",4959,2369,2590,4886,73,46
"37UGGX","Farndon",4001,1902,2099,3955,46,45
"37UGGY","Farnsfield",4747,2317,2430,4672,75,103
"37UGGZ","Lowdham",4954,2681,2273,4421,533,100
"37UGHA","Magnus",4670,2265,2405,4589,81,24
"37UGHB","Muskham",2535,1251,1284,2520,15,60
"37UGHC","Ollerton",6619,3228,3391,6578,41,51
"37UGHD","Rainworth",5139,2525,2614,5139,0,28
"37UGHE","Southwell East",1947,921,1026,1947,0,62
"37UGHF","Southwell North",2197,1074,1123,2197,0,59
"37UGHG","Southwell West",2421,1149,1272,2335,86,60
"37UGHH","Sutton-on-Trent",2542,1254,1288,2530,12,49
"37UGHJ","Trent",2324,1172,1152,2289,35,58
"37UGHK","Winthorpe",2050,1010,1040,2025,25,26
"37UJGG","Abbey",4559,2241,2318,4559,0,83
"37UJGH","Bingham East",4260,2036,2224,4231,29,62
"37UJGJ","Bingham West",4425,2184,2241,4425,0,41
"37UJGK","Compton Acres",4918,2463,2455,4834,84,75
"37UJGL","Cotgrave",7373,3612,3761,7262,111,53
"37UJGM","Cranmer",2107,1169,938,1785,322,34
"37UJGN","Edwalton Village",3764,1790,1974,3734,30,72
"37UJGP","Gamston",4840,2370,2470,4777,63,57
"37UJGQ","Gotham",2057,1011,1046,2057,0,30
"37UJGR","Keyworth North",1666,813,853,1666,0,51
"37UJGS","Keyworth South",5254,2546,2708,5224,30,99
"37UJGT","Lady Bay",4858,2491,2367,4810,48,49
"37UJGU","Leake",6236,3079,3157,6153,83,98
"37UJGW","Lutterell",3697,1722,1975,3697,0,58
"37UJGX","Manvers",3917,1876,2041,3869,48,77
"37UJGY","Melton",4232,2046,2186,4207,25,90
"37UJGZ","Musters",4136,2043,2093,4092,44,92
"37UJHA","Nevile",1872,933,939,1872,0,49
"37UJHB","Oak",2156,1041,1115,2133,23,55
"37UJHC","Ruddington",6441,3106,3335,6308,133,69
"37UJHD","Soar Valley",2123,1035,1088,1889,234,45
"37UJHE","Stanford",2356,1163,1193,2327,29,45
"37UJHF","Thoroton",1958,989,969,1955,3,50
"37UJHG","Tollerton",1776,881,895,1776,0,30
"37UJHH","Trent",4520,2124,2396,4393,127,77
"37UJHJ","Trent Bridge",4513,2294,2219,4292,221,30
"37UJHK","Wiverton",3597,1788,1809,3595,0,56
"37UJHL","Wolds",1988,963,1025,1941,47,44
"38UBGJ","Adderbury",2712,1299,1413,2633,79,46
"38UBGK","Ambrosden and Chesterton",3330,1809,1521,2928,402,64
"38UBGL","Banbury Calthorpe",5382,2649,2733,5343,39,86
"38UBGM","Banbury Easington",7598,3572,4026,7343,255,73
"38UBGN","Banbury Grimsbury and Castle",8892,4387,4505,8821,71,45
"38UBGP","Banbury Hardwick",5977,2995,2982,5977,0,29
"38UBGQ","Banbury Neithrop",5531,2748,2783,5480,51,20
"38UBGR","Banbury Ruscote",8422,4104,4318,8422,0,28
"38UBGS","Bicester East",6183,3027,3156,6183,0,56
"38UBGT","Bicester North",5650,2800,2850,5650,0,41
"38UBGU","Bicester South",4371,2224,2147,4371,0,31
"38UBGW","Bicester Town",4922,2346,2576,4892,30,31
"38UBGX","Bicester West",7546,3701,3845,7546,0,66
"38UBGY","Bloxham and Bodicote",5827,2946,2881,5596,231,115
"38UBGZ","Caversfield",2899,1401,1498,2776,123,35
"38UBHA","Cropredy",2702,1314,1388,2653,49,58
"38UBHB","Deddington",2643,1279,1364,2601,42,54
"38UBHC","Fringford",2338,1173,1165,2336,3,56
"38UBHD","Hook Norton",2495,1189,1306,2495,0,70
"38UBHE","Kidlington North",5271,2600,2671,5139,132,76
"38UBHF","Kidlington South",8448,4067,4381,8403,45,65
"38UBHG","Kirtlington",2856,1413,1443,2808,48,69
"38UBHH","Launton",3048,1845,1203,2510,538,29
"38UBHJ","Otmoor",2455,1226,1229,2349,106,58
"38UBHK","Sibford",2512,1255,1257,2413,99,74
"38UBHL","The Astons and Heyfords",4704,2348,2356,4702,3,105
"38UBHM","Wroxton",2530,1245,1285,2499,31,66
"38UBHN","Yarnton, Gosford and Water Eaton",4541,2206,2335,4457,84,69
"38UCFT","Barton and Sandhills",5881,2847,3034,5833,48,22
"38UCFU","Blackbird Leys",5803,2821,2982,5759,44,20
"38UCFW","Carfax",4573,2616,1957,1847,2726,37
"38UCFX","Churchill",6075,2939,3136,5395,680,39
"38UCFY","Cowley",5460,2712,2748,5460,0,38
"38UCFZ","Cowley Marsh",4886,2472,2414,4637,249,37
"38UCGA","Headington",5619,2583,3036,5324,295,101
"38UCGB","Headington Hill and Northway",4887,2251,2636,4095,792,36
"38UCGC","Hinksey Park",5820,2932,2888,5565,255,60
"38UCGD","Holywell",4313,2470,1843,556,3757,6
"38UCGE","Iffley Fields",5215,2596,2619,5083,132,40
"38UCGF","Jericho and Osney",5870,2999,2871,5553,317,49
"38UCGG","Littlemore",5653,2808,2845,5579,74,31
"38UCGH","Lye Valley",6157,3008,3149,5965,192,57
"38UCGJ","Marston",6114,2957,3157,6078,36,64
"38UCGK","North",5467,2727,2740,3857,1610,146
"38UCGL","Northfield Brook",6393,3050,3343,6330,63,19
"38UCGM","Quarry and Risinghurst",5978,2899,3079,5959,19,81
"38UCGN","Rose Hill and Iffley",6025,2939,3086,5966,59,66
"38UCGP","St Clement's",5731,2761,2970,5477,254,75
"38UCGQ","St Margaret's",4605,2308,2297,3582,1023,139
"38UCGR","St Mary's",5040,2416,2624,4536,504,36
"38UCGS","Summertown",7041,3453,3588,6192,849,148
"38UCGT","Wolvercote",5642,2720,2922,5623,19,122
"38UDGK","Aston Rowant",2380,1185,1195,2380,0,51
"38UDGL","Benson",6091,3170,2921,5626,465,118
"38UDGM","Berinsfield",5772,2858,2914,5761,11,67
"38UDGN","Brightwell",2567,1232,1335,2464,103,60
"38UDGP","Chalgrove",2909,1477,1432,2909,0,34
"38UDGQ","Chiltern Woods",2267,1094,1173,2264,3,70
"38UDGR","Chinnor",5857,2935,2922,5825,32,75
"38UDGS","Cholsey and Wallingford South",5072,2474,2598,4883,189,100
"38UDGT","Crowmarsh",2414,1288,1126,2149,265,46
"38UDGU","Didcot All Saints",5472,2681,2791,5406,66,51
"38UDGW","Didcot Ladygrove",7100,3574,3526,7100,0,33
"38UDGX","Didcot Northbourne",5289,2691,2598,5289,0,32
"38UDGY","Didcot Park",5592,2698,2894,5582,10,46
"38UDGZ","Forest Hill and Holton",2879,1427,1452,2560,319,58
"38UDHA","Garsington",2672,1349,1323,2649,23,44
"38UDHB","Goring",5506,2678,2828,5392,114,162
"38UDHC","Great Milton",2708,1334,1374,2675,33,42
"38UDHD","Hagbourne",2708,1338,1370,2708,0,70
"38UDHE","Henley North",5202,2389,2813,5127,75,84
"38UDHF","Henley South",5444,2577,2867,5443,3,112
"38UDHG","Sandford",2587,1246,1341,2404,183,46
"38UDHH","Shiplake",4914,2527,2387,4631,283,172
"38UDHJ","Sonning Common",5251,2522,2729,5213,38,127
"38UDHK","Thame North",5822,2807,3015,5816,6,79
"38UDHL","Thame South",5250,2533,2717,5172,78,87
"38UDHM","Wallingford North",5330,2573,2757,5277,53,51
"38UDHN","Watlington",5141,2517,2624,5120,21,124
"38UDHP","Wheatley",5277,2584,2693,5251,26,95
"38UDHQ","Woodcote",2715,1450,1265,2486,229,63
"38UEGJ","Abingdon Abbey and Barton",4524,2215,2309,4459,65,43
"38UEGK","Abingdon Caldecott",4416,2181,2235,4416,0,27
"38UEGL","Abingdon Dunmore",4774,2406,2368,4774,0,85
"38UEGM","Abingdon Fitzharris",4296,2144,2152,4116,180,85
"38UEGN","Abingdon Northcourt",4604,2250,2354,4599,5,75
"38UEGP","Abingdon Ock Meadow",4153,1999,2154,4114,39,49
"38UEGQ","Abingdon Peachcroft",4522,2277,2245,4522,0,91
"38UEGR","Appleton and Cumnor",6400,3139,3261,6333,67,178
"38UEGS","Blewbury and Upton",1942,939,1003,1942,0,50
"38UEGT","Craven",2233,1096,1137,2217,16,79
"38UEGU","Drayton",2218,1072,1146,2218,0,35
"38UEGW","Faringdon and The Coxwells",7013,3431,3582,6956,57,111
"38UEGX","Greendown",2182,1112,1070,2182,0,49
"38UEGY","Grove",7418,3742,3676,7415,3,127
"38UEGZ","Hanneys",2180,1092,1088,2180,0,85
"38UEHA","Harwell",3780,1867,1913,3725,55,54
"38UEHB","Hendreds",4060,2014,2046,4057,3,87
"38UEHC","Kennington and South Hinksey",4264,2132,2132,4162,102,71
"38UEHD","Kingston Bagpuize with Southmoor",2269,1111,1158,2247,22,47
"38UEHE","Longworth",2243,1101,1142,2238,5,53
"38UEHF","Marcham and Shippon",3858,2204,1654,2952,906,70
"38UEHG","North Hinksey and Wytham",4447,2084,2363,4137,310,77
"38UEHH","Radley",2774,1696,1078,2125,649,44
"38UEHJ","Shrivenham",5468,2839,2629,5249,219,201
"38UEHK","Stanford",2136,1036,1100,2089,47,32
"38UEHL","Sunningwell and Wootton",4186,2052,2134,4145,41,94
"38UEHM","Sutton Courtenay and Appleford",2772,1356,1416,2769,3,47
"38UEHN","Wantage Charlton",6139,2813,3326,5812,327,88
"38UEHP","Wantage Segsbury",4356,2106,2250,4292,64,85
"38UFGL","Alvescot and Filkins",1684,822,862,1684,0,47
"38UFGM","Ascott and Shipton",1968,945,1023,1921,47,51
"38UFGN","Bampton and Clanfield",3634,1834,1800,3626,8,89
"38UFGP","Brize Norton and Shilton",2743,1619,1124,1821,922,35
"38UFGQ","Burford",1878,896,982,1756,122,35
"38UFGR","Carterton North East",2995,1501,1494,2995,0,19
"38UFGS","Carterton North West",4599,2288,2311,4599,0,54
"38UFGT","Carterton South",4211,2090,2121,4171,40,63
"38UFGU","Chadlington and Churchill",1938,926,1012,1894,44,65
"38UFGW","Charlbury and Finstock",3777,1855,1922,3774,3,95
"38UFGX","Chipping Norton",5972,2879,3093,5889,83,77
"38UFGY","Ducklington",2063,1022,1041,2063,0,28
"38UFGZ","Eynsham and Cassington",5725,2785,2940,5669,56,108
"38UFHA","Freeland and Hanborough",4123,2001,2122,4049,74,100
"38UFHB","Hailey, Minster Lovell and Leafield",3866,1904,1962,3839,27,83
"38UFHC","Kingham, Rollright and Enstone",4122,2021,2101,3844,278,109
"38UFHD","Milton-under-Wychwood",1953,930,1023,1939,14,43
"38UFHE","North Leigh",1919,974,945,1904,15,48
"38UFHF","Standlake, Aston and Stanton Harcourt",3972,1974,1998,3883,89,77
"38UFHG","Stonesfield and Tackley",4041,1963,2078,4041,0,82
"38UFHH","The Bartons",1937,938,999,1937,0,29
"38UFHJ","Witney Central",3870,1908,1962,3799,71,29
"38UFHK","Witney East",4488,2152,2336,4437,51,69
"38UFHL","Witney North",4164,2054,2110,4142,22,65
"38UFHM","Witney South",5965,2920,3045,5957,8,53
"38UFHN","Witney West",4278,2144,2134,4278,0,48
"38UFHP","Woodstock and Bladon",3755,1746,2009,3686,69,48
"39UBFX","Albrighton South",3056,1459,1597,3056,0,31
"39UBFY","Alveley",2920,1471,1449,2903,17,53
"39UBFZ","Bridgnorth Castle",2877,1428,1449,2825,52,81
"39UBGA","Bridgnorth East",2882,1397,1485,2798,84,50
"39UBGB","Bridgnorth Morfe",3007,1498,1509,2972,35,29
"39UBGC","Bridgnorth West",2976,1457,1519,2976,0,27
"39UBGD","Broseley East",2804,1368,1436,2799,5,33
"39UBGE","Broseley West",2744,1369,1375,2741,3,26
"39UBGF","Claverley",1477,726,751,1477,0,18
"39UBGG","Ditton Priors",1557,770,787,1508,49,15
"39UBGH","Donington and Albrighton North",5131,3374,1757,3152,1979,71
"39UBGJ","Glazeley",1515,762,753,1509,6,21
"39UBGK","Harrington",1403,719,684,1403,0,22
"39UBGL","Highley",3298,1597,1701,3298,0,29
"39UBGM","Morville",1498,737,761,1484,14,42
"39UBGN","Much Wenlock",3041,1450,1591,2972,69,63
"39UBGP","Shifnal Idsall",2831,1398,1433,2809,22,39
"39UBGQ","Shifnal Manor",2550,1247,1303,2550,0,36
"39UBGR","Shifnal  Rural",1713,849,864,1697,16,22
"39UBGS","Stottesdon",1690,873,817,1580,110,34
"39UBGT","Worfield",1527,722,805,1441,86,28
"39UCGD","Baschurch",1475,720,755,1416,59,31
"39UCGE","Clive and Myddle",2552,1289,1263,2546,6,43
"39UCGF","Cockshutt",1297,660,637,1141,156,30
"39UCGG","Dudleston Heath",1417,708,709,1390,27,31
"39UCGH","Ellesmere and Welshampton",3896,1877,2019,3868,28,45
"39UCGJ","Hinstock",2573,1286,1287,2511,62,38
"39UCGK","Hodnet",2612,1302,1310,2565,47,50
"39UCGL","Hordley,Tetchill and Lyneal",1524,825,699,1341,183,24
"39UCGM","Market Drayton East",2914,1376,1538,2911,3,45
"39UCGN","Market Drayton North",4504,2209,2295,4499,5,48
"39UCGP","Market Drayton South",2989,1465,1524,2989,0,28
"39UCGQ","Prees",2688,1342,1346,2661,27,26
"39UCGR","Shavington",1424,723,701,1387,37,37
"39UCGS","Shawbury",3044,1593,1451,2828,216,55
"39UCGT","Sutton",2547,1591,956,1955,592,41
"39UCGU","Wem East",2463,1135,1328,2422,41,27
"39UCGW","Wem Rural",1423,735,688,1376,47,30
"39UCGX","Wem West",2679,1284,1395,2598,81,27
"39UCGY","Whitchurch North",2714,1302,1412,2676,38,36
"39UCGZ","Whitchurch Rural",1432,713,719,1373,59,21
"39UCHA","Whitchurch South",2957,1469,1488,2881,76,20
"39UCHB","Whitchurch West",3144,1533,1611,3139,5,20
"39UCHC","Whixhall",1429,713,716,1429,0,25
"39UCHD","Woore",1411,701,710,1410,0,48
"39UDFR","Cabin Lane",2330,1132,1198,2304,26,14
"39UDFS","Cambrian",2346,1091,1255,2342,4,11
"39UDFT","Carreg Llwyd",2764,1305,1459,2764,0,10
"39UDFU","Castle",2634,1226,1408,2536,98,40
"39UDFW","Gatacre",2939,1414,1525,2928,11,11
"39UDFX","Gobowen",3927,1925,2002,3616,311,45
"39UDFY","Kinnerley",1304,645,659,1304,0,32
"39UDFZ","Llanyblodwel and Pant",2317,1162,1155,2307,10,26
"39UDGA","Maserfield",2600,1251,1349,2475,125,45
"39UDGB","Ruyton and West Felton",2577,1284,1293,2386,191,44
"39UDGC","St. Martin's",2636,1317,1319,2626,10,17
"39UDGD","Sweeney and Trefonen",3776,1870,1906,3739,37,89
"39UDGE","Weston Rhyn",2668,1177,1491,2438,230,27
"39UDGF","Whittington",2490,1231,1259,2476,14,46
"39UEFZ","Bagley",4621,2203,2418,4436,185,36
"39UEGA","Battlefield and Heathgates",4754,2348,2406,4738,16,34
"39UEGB","Bayston Hill",5247,2586,2661,5200,47,93
"39UEGC","Belle Vue",4430,2103,2327,4357,73,73
"39UEGD","Bowbrook",5183,2485,2698,4939,244,67
"39UEGE","Castlefields and Quarry",4488,2262,2226,4312,176,37
"39UEGF","Column",4369,2120,2249,4318,51,108
"39UEGG","Condover",2140,1053,1087,2044,96,44
"39UEGH","Copthorne",4371,2063,2308,4329,42,121
"39UEGJ","Hanwood and Longden",2311,1142,1169,2306,5,35
"39UEGK","Harlescott",5203,2541,2662,5182,21,29
"39UEGL","Haughmond and Attingham",2231,1101,1130,2207,24,46
"39UEGM","Lawley",2584,1316,1268,2316,268,98
"39UEGN","Meole Brace",4725,2268,2457,4660,65,70
"39UEGP","Monkmoor",5499,2630,2869,5421,78,34
"39UEGQ","Montford",2397,1203,1194,2390,7,57
"39UEGR","Pimhill",2008,984,1024,1982,26,36
"39UEGS","Porthill",5246,2769,2477,4573,673,136
"39UEGT","Rea Valley",5029,2541,2488,4868,161,84
"39UEGU","Rowton",2665,1354,1311,2648,17,39
"39UEGW","Severn Valley",2112,1050,1062,2112,0,51
"39UEGX","Sundorne",5123,2547,2576,5123,0,26
"39UEGY","Sutton and Reabrook",4209,2022,2187,4191,18,42
"39UEGZ","Underdale",4905,2380,2525,4823,82,53
"39UFGF","Apedale",1118,576,542,1118,0,17
"39UFGG","Bishop's Castle with Onny Valley",2476,1214,1262,2399,77,35
"39UFGH","Bitterley with Stoke St Milborough",1319,649,670,1315,4,26
"39UFGJ","Bucknell",1189,597,592,1055,134,15
"39UFGK","Burford",1308,658,650,1305,3,22
"39UFGL","Caynham with Ashford",1221,592,629,1177,44,33
"39UFGM","Chirbury",914,467,447,914,0,13
"39UFGN","Church Stretton North",1970,893,1077,1890,80,26
"39UFGP","Church Stretton South",2216,1028,1188,2141,75,41
"39UFGQ","Clee",2614,1301,1313,2582,32,39
"39UFGR","Cleobury Mortimer",2774,1356,1418,2756,18,39
"39UFGS","Clun",1086,527,559,1086,0,16
"39UFGT","Clun Forest",964,501,463,964,0,22
"39UFGU","Corve Valley",1045,535,510,1020,25,18
"39UFGW","Kemp Valley",1147,563,584,1135,12,22
"39UFGX","Ludlow Henley",2505,1154,1351,2457,48,12
"39UFGY","Ludlow St Laurence's",2167,1020,1147,2111,56,45
"39UFGZ","Ludlow St Peter's",2447,1184,1263,2442,5,25
"39UFHA","Ludlow Sheet with Ludford",2824,1406,1418,2822,0,22
"39UFHB","Stokesay",2589,1299,1290,2566,23,15
"39UFHC","Upper Corvedale",1329,686,643,1329,0,29
"39UFHD","Wistanstow with Hopesay",1259,616,643,1259,0,23
"39UFHE","Worthen",1929,963,966,1926,3,35
"40UBGK","Ashwick and Ston Easton",2285,1118,1167,2170,115,46
"40UBGL","Avalon",2405,1180,1225,2304,101,62
"40UBGM","Beacon",2624,1293,1331,2546,78,50
"40UBGN","Beckington and Rode",2310,1101,1209,2287,23,69
"40UBGP","Chilcompton",2029,1025,1004,1994,35,27
"40UBGQ","Coleford",2350,1178,1172,2350,0,17
"40UBGR","Creech",2300,1065,1235,2243,57,19
"40UBGS","Frome Berkley Down",5045,2460,2585,5009,36,73
"40UBGT","Frome Fromefield",3878,1837,2041,3876,0,51
"40UBGU","Frome Keyford",5358,2638,2720,5342,16,48
"40UBGW","Frome Park",4910,2413,2497,4760,150,43
"40UBGX","Frome Welshmill",5319,2515,2804,5200,119,48
"40UBGY","Glastonbury St Benedict's",2584,1196,1388,2445,139,18
"40UBGZ","Glastonbury St Edmund's",2394,1194,1200,2136,258,29
"40UBHA","Glastonbury St John's",2102,1000,1102,2088,14,13
"40UBHB","Glastonbury St Mary's",1704,800,904,1624,80,26
"40UBHC","Knowle",2055,989,1066,1980,75,60
"40UBHD","Mells",2222,1120,1102,2222,0,51
"40UBHE","Moor",2698,1398,1300,2623,75,47
"40UBHF","Nedge",2074,1050,1024,2074,0,41
"40UBHG","Nordinton",2017,1014,1003,2002,15,42
"40UBHH","Postlebury",2269,1119,1150,2241,28,42
"40UBHJ","Pylcombe",1993,993,1000,1986,7,66
"40UBHK","Rodney and Priddy",1858,869,989,1833,25,24
"40UBHL","St Cuthbert (Out) North and West",2133,1022,1111,2089,44,39
"40UBHM","Shepton East",4300,2206,2094,4085,215,34
"40UBHN","Shepton West",4681,2276,2405,4655,26,29
"40UBHP","Stratton",2486,1373,1113,2152,334,36
"40UBHQ","Street North",4833,2378,2455,4562,271,39
"40UBHR","Street South",4054,1943,2111,3597,457,45
"40UBHS","Street West",2179,1097,1082,2168,11,35
"40UBHT","Vale",2014,973,1041,2009,5,54
"40UBHU","Wells Central",1703,774,929,1648,55,24
"40UBHW","Wells St Cuthbert's",4577,2156,2421,4482,95,55
"40UBHX","Wells St Thomas'",4126,1962,2164,3872,254,73
"40UCGJ","Axbridge",2025,976,1049,1959,66,27
"40UCGK","Axe Vale",2035,1002,1033,2028,7,50
"40UCGL","Berrow",2329,1167,1162,2206,123,17
"40UCGM","Brent North",2162,1068,1094,2130,32,34
"40UCGN","Bridgwater Bower",6274,3107,3167,6272,0,34
"40UCGP","Bridgwater Eastover",4095,2033,2062,4068,27,10
"40UCGQ","Bridgwater Hamp",6973,3335,3638,6903,70,35
"40UCGR","Bridgwater Quantock",6146,2927,3219,6024,122,82
"40UCGS","Bridgwater Sydenham",6614,3207,3407,6582,32,24
"40UCGT","Bridgwater Victoria",4769,2323,2446,4728,41,26
"40UCGU","Burnham North",6200,2889,3311,5869,331,86
"40UCGW","Burnham South",6215,2919,3296,6073,142,42
"40UCGX","Cannington and Quantocks",6991,3444,3547,6739,252,99
"40UCGY","Cheddar and Shipham",6115,2944,3171,6042,73,107
"40UCGZ","East Poldens",2088,1089,999,1972,116,35
"40UCHA","Highbridge",5986,2893,3093,5977,9,33
"40UCHB","Huntspill and Pawlett",3630,1809,1821,3616,14,37
"40UCHC","King's Isle",4409,2172,2237,4388,21,38
"40UCHD","Knoll",2050,988,1062,1981,69,29
"40UCHE","North Petherton",5558,2775,2783,5550,8,72
"40UCHF","Puriton",2033,983,1050,2027,6,26
"40UCHG","Sandford",2021,1011,1010,1983,38,49
"40UCHH","Wedmore and Mark",4539,2287,2252,4418,121,93
"40UCHJ","West Poldens",2461,1203,1258,2399,62,33
"40UCHK","Woolavington",2163,1038,1125,2163,0,11
"40UDJP","Blackdown",2204,1079,1125,2195,9,44
"40UDJQ","Blackmoor Vale",5022,2478,2544,4942,80,129
"40UDJR","Bruton",2926,1566,1360,2395,531,64
"40UDJS","Brympton",5268,2643,2625,5118,150,60
"40UDJT","Burrow Hill",2197,1066,1131,2197,0,41
"40UDJU","Camelot",2559,1278,1281,2471,88,60
"40UDJW","Cary",5193,2466,2727,5083,110,101
"40UDJX","Chard Avishayes",2359,1162,1197,2333,26,21
"40UDJY","Chard Combe",2061,950,1111,2013,48,17
"40UDJZ","Chard Crimchard",2755,1354,1401,2750,5,22
"40UDKA","Chard Holyrood",2436,1158,1278,2420,16,20
"40UDKB","Chard Jocelyn",2397,1103,1294,2342,55,15
"40UDKC","Coker",5258,2549,2709,5258,0,102
"40UDKD","Crewkerne",7520,3605,3915,7449,71,73
"40UDKE","Curry Rivel",2497,1202,1295,2442,55,52
"40UDKF","Eggwood",2413,1179,1234,2392,21,42
"40UDKG","Hamdon",2689,1324,1365,2689,0,24
"40UDKH","Ilminster",4753,2252,2501,4699,54,34
"40UDKJ","Islemoor",2776,1347,1429,2756,20,43
"40UDKK","Ivelchester",4008,2297,1711,3266,742,71
"40UDKL","Langport and Huish",2735,1281,1454,2653,82,30
"40UDKM","Martock",5454,2671,2783,5430,24,84
"40UDKN","Milborne Port",2644,1294,1350,2639,5,55
"40UDKP","Neroche",2280,1093,1187,2227,53,38
"40UDKQ","Northstone",2917,1471,1446,2801,116,84
"40UDKR","Parrett",2330,1120,1210,2320,10,52
"40UDKS","St Michael's",2302,1137,1165,2284,18,41
"40UDKT","South Petherton",4642,2238,2404,4599,43,71
"40UDKU","Tatworth and Forton",2580,1281,1299,2574,6,17
"40UDKW","Tower",2388,1115,1273,2249,139,80
"40UDKX","Turn Hill",2497,1257,1240,2497,0,67
"40UDKY","Wessex",5173,2434,2739,5079,94,98
"40UDKZ","Wincanton",4639,2280,2359,4568,71,69
"40UDLA","Windwhistle",2225,1088,1137,2207,18,42
"40UDLB","Yeovil Central",7230,3634,3596,7040,190,50
"40UDLC","Yeovil East",7300,3522,3778,7214,86,36
"40UDLD","Yeovil South",7802,3849,3953,7687,115,93
"40UDLE","Yeovil West",7280,3420,3860,7140,140,82
"40UDLF","Yeovil Without",7260,3562,3698,7248,12,96
"40UEGH","Bishop's Hull",3678,1668,2010,3507,171,50
"40UEGJ","Bishop's Lydeard",3986,1922,2064,3920,66,65
"40UEGK","Blackdown",2130,1061,1069,2109,21,40
"40UEGL","Bradford-on-Tone",2138,1049,1089,2112,26,51
"40UEGM","Comeytrowe",5583,2642,2941,5355,228,88
"40UEGN","Milverton and North Deane",2958,1440,1518,2951,7,76
"40UEGP","Monument",2018,988,1030,1908,110,48
"40UEGQ","Neroche",2057,986,1071,1993,64,52
"40UEGR","North Curry",1740,859,881,1735,5,26
"40UEGS","Norton Fitzwarren",2411,1397,1014,1992,419,27
"40UEGT","Ruishton and Creech",3887,1889,1998,3846,41,54
"40UEGU","Staplegrove",3992,1912,2080,3665,327,80
"40UEGW","Stoke St. Gregory",1391,688,703,1391,0,25
"40UEGX","Taunton Blackbrook and Holway",6508,3084,3424,6462,46,39
"40UEGY","Taunton Eastgate",4137,2072,2065,3756,381,36
"40UEGZ","Taunton Fairwater",5686,2751,2935,5621,65,51
"40UEHA","Taunton Halcon",6207,2961,3246,6138,69,21
"40UEHB","Taunton Killams and Mountfield",3083,1457,1626,2988,95,58
"40UEHC","Taunton Lyngford",5317,2523,2794,5283,34,26
"40UEHD","Taunton Manor and Wilton",5181,2354,2827,5023,158,106
"40UEHE","Taunton Pyrland and Rowbarton",5911,2813,3098,5875,36,42
"40UEHF","Trull",2004,952,1052,1828,176,53
"40UEHG","Wellington East",3491,1674,1817,3367,124,47
"40UEHH","Wellington North",4125,1964,2161,4030,95,34
"40UEHJ","Wellington Rockwell Green and West",5229,2457,2772,5141,88,64
"40UEHK","West Monkton",3837,1860,1977,3777,60,54
"40UEHL","Wiveliscombe and West Deane",3614,1781,1833,3550,64,78
"40UFFW","Alcombe East",1916,948,968,1321,595,8
"40UFFX","Alcombe West",2569,1205,1364,2533,36,19
"40UFFY","Aville Vale",1159,536,623,1154,5,26
"40UFFZ","Brompton Ralph and Haddon",859,437,422,859,0,20
"40UFGA","Carhampton and Withycombe",1291,624,667,1290,0,22
"40UFGB","Crowcombe and Stogumber",1085,522,563,1076,9,37
"40UFGC","Dulverton and Brushford",2021,973,1048,1989,32,28
"40UFGD","Dunster",854,393,461,854,0,13
"40UFGE","Exmoor",867,417,450,862,5,12
"40UFGF","Minehead North",3302,1493,1809,2947,355,27
"40UFGG","Minehead South",3912,1821,2091,3860,52,31
"40UFGH","Old Cleeve",2306,1077,1229,2270,36,33
"40UFGJ","Porlock and District",2229,1049,1180,2199,30,29
"40UFGK","Quantock Vale",2049,1004,1045,2032,17,19
"40UFGL","Quarme",973,456,517,971,3,22
"40UFGM","Watchet",3949,1944,2005,3937,12,35
"40UFGN","West Quantock",1160,575,585,1090,70,11
"40UFGP","Williton",2574,1163,1411,2497,77,28
"41UBFR","Brereton and Ravenhill",6524,3171,3353,6463,61,22
"41UBFS","Cannock East",6987,3401,3586,6974,13,27
"41UBFT","Cannock North",7587,3724,3863,7572,15,18
"41UBFU","Cannock South",7162,3484,3678,7074,88,31
"41UBFW","Cannock West",6699,3232,3467,6581,118,81
"41UBFX","Etching Hill and The Heath",7002,3488,3514,6983,19,65
"41UBFY","Hagley",3340,1674,1666,3340,0,13
"41UBFZ","Hawks Green",6324,3194,3130,6324,0,39
"41UBGA","Heath Hayes East and Wimblebury",5852,2872,2980,5783,69,25
"41UBGB","Hednesford Green Heath",4831,2413,2418,4831,0,17
"41UBGC","Hednesford North",7038,3448,3590,7038,0,23
"41UBGD","Hednesford South",5092,2476,2616,4985,107,27
"41UBGE","Norton Canes",6394,3207,3187,6378,16,29
"41UBGF","Rawnsley",4920,2479,2441,4888,32,37
"41UBGG","Western Springs",6374,3112,3262,6273,101,55
"41UCGC","Abbey",2722,1365,1357,2666,56,38
"41UCGD","Anglesey",5835,2876,2959,5747,88,47
"41UCGE","Bagots",2468,1176,1292,2394,74,58
"41UCGF","Branston",7040,3509,3531,7010,30,46
"41UCGG","Brizlincote",5087,2513,2574,5024,63,49
"41UCGH","Burton",2127,1039,1088,2106,21,9
"41UCGJ","Churnet",2462,1235,1227,2317,145,36
"41UCGK","Crown",2532,1195,1337,2426,106,49
"41UCGL","Eton Park",5378,2607,2771,5323,55,27
"41UCGM","Heath",6049,2934,3115,6018,31,39
"41UCGN","Horninglow",7828,3687,4141,7750,78,51
"41UCGP","Needwood",5386,2645,2741,5384,3,120
"41UCGQ","Rolleston on Dove",3134,1522,1612,3123,11,49
"41UCGR","Shobnall",6130,2962,3168,6080,50,59
"41UCGS","Stapenhill",7900,3865,4035,7863,37,28
"41UCGT","Stretton",7763,3769,3994,7724,39,76
"41UCGU","Town",5974,2944,3030,5848,126,63
"41UCGW","Tutbury and Outwoods",5260,2579,2681,5248,12,67
"41UCGX","Weaver",2090,1031,1059,2089,0,27
"41UCGY","Winshill",8115,3925,4190,7990,125,66
"41UCGZ","Yoxall",2490,1204,1286,2461,29,71
"41UDGE","All Saints",3611,1747,1864,3517,94,37
"41UDGF","Alrewas and Fradley",4686,2309,2377,4668,18,68
"41UDGG","Armitage with Handsacre",5181,2589,2592,5116,65,26
"41UDGH","Boley Park",4890,2367,2523,4839,51,132
"41UDGJ","Boney Hay",3295,1635,1660,3277,18,24
"41UDGK","Bourne Vale",1993,1144,849,1689,304,26
"41UDGL","Burntwood Central",3250,1623,1627,3213,37,29
"41UDGM","Chadsmead",3661,1748,1913,3624,37,24
"41UDGN","Chase Terrace",5068,2482,2586,5011,57,32
"41UDGP","Chasetown",3581,1705,1876,3475,106,27
"41UDGQ","Colton and Mavesyn Ridware",1750,876,874,1674,76,26
"41UDGR","Curborough",5237,2551,2686,5237,0,50
"41UDGS","Fazeley",4581,2251,2330,4552,29,26
"41UDGT","Hammerwich",3420,1667,1753,3370,50,50
"41UDGU","Highfield",3194,1602,1592,3156,38,73
"41UDGW","King's Bromley",1651,815,836,1599,52,39
"41UDGX","Leomansley",3816,1780,2036,3703,113,71
"41UDGY","Little Aston",2832,1372,1460,2770,62,72
"41UDGZ","Longdon",1807,890,917,1790,17,42
"41UDHA","Mease and Tame",3383,1660,1723,3298,85,61
"41UDHB","St John's",5173,2565,2608,5173,0,155
"41UDHC","Shenstone",3206,1536,1670,3076,130,49
"41UDHD","Stonnall",1470,712,758,1470,0,18
"41UDHE","Stowe",5123,2534,2589,5050,73,80
"41UDHF","Summerfield",4036,1958,2078,4036,0,25
"41UDHG","Whittington",3337,1671,1666,3252,85,74
"41UEGA","Audley and Bignall End",5770,2828,2942,5751,19,34
"41UEGB","Bradwell",6362,3098,3264,6157,205,14
"41UEGC","Butt Lane",5572,2715,2857,5506,66,24
"41UEGD","Chesterton",7111,3465,3646,7053,58,26
"41UEGE","Clayton",4027,1959,2068,4023,4,31
"41UEGF","Cross Heath",6157,2975,3182,6149,8,16
"41UEGG","Halmerend",3547,1727,1820,3501,46,36
"41UEGH","Holditch",4567,2220,2347,4526,41,5
"41UEGJ","Keele",3672,1649,2023,821,2851,21
"41UEGK","Kidsgrove",7150,3565,3585,7132,18,22
"41UEGL","Knutton and Silverdale",4120,2012,2108,4096,24,9
"41UEGM","Loggerheads and Whitmore",6599,3284,3315,6559,40,138
"41UEGN","Madeley",4386,2111,2275,4326,60,50
"41UEGP","May Bank",6445,3108,3337,6328,117,59
"41UEGQ","Newchapel",3239,1574,1665,3239,0,15
"41UEGR","Porthill",4081,1955,2126,4028,53,13
"41UEGS","Ravenscliffe",4074,2029,2045,4056,18,22
"41UEGT","Seabridge",6036,2971,3065,6036,0,58
"41UEGU","Silverdale and Parksite",3653,1803,1850,3635,18,9
"41UEGW","Talke",4077,2026,2051,4074,3,17
"41UEGX","Thistleberry",5739,2690,3049,5705,34,54
"41UEGY","Town",4453,2075,2378,4321,132,22
"41UEGZ","Westlands",5747,2785,2962,5731,16,122
"41UEHA","Wolstanton",5446,2618,2828,5384,62,38
"41UFHM","Bilbrook",4077,1959,2118,4042,35,29
"41UFHN","Brewood and Coven",6374,3112,3262,6374,0,59
"41UFHP","Cheslyn Hay North and Saredon",4221,2108,2113,4221,0,28
"41UFHQ","Cheslyn Hay South",4017,2025,1992,4017,0,43
"41UFHR","Codsall North",4036,1912,2124,4000,36,52
"41UFHS","Codsall South",3952,1876,2076,3812,140,88
"41UFHT","Essington",4831,2361,2470,4677,154,35
"41UFHU","Featherstone and Shareshill",5634,3103,2531,4988,646,21
"41UFHW","Great Wyrley Landywood",4986,2467,2519,4978,8,21
"41UFHX","Great Wyrley Town",6250,3050,3200,6183,67,36
"41UFHY","Himley and Swindon",1994,971,1023,1854,140,17
"41UFHZ","Huntington and Hatherton",4472,2212,2260,4431,41,21
"41UFJA","Kinver",6805,3304,3501,6648,157,111
"41UFJB","Pattingham and Patshull",2229,1096,1133,2229,0,58
"41UFJC","Penkridge North East and Acton Trussell",3579,1767,1812,3552,27,56
"41UFJD","Penkridge South East",4480,2191,2289,4407,73,51
"41UFJE","Penkridge West",2138,1054,1084,2076,62,35
"41UFJF","Perton Dippons",2002,982,1020,1980,22,13
"41UFJG","Perton East",2379,1181,1198,2379,0,24
"41UFJH","Perton Lakeside",6737,3277,3460,6737,0,48
"41UFJJ","Trysull and Seisdon",2075,1032,1043,2047,28,36
"41UFJK","Wheaton Aston, Bishopswood and Lapley",3963,1978,1985,3926,37,83
"41UFJL","Wombourne North and Lower Penn",6043,2961,3082,5970,73,42
"41UFJM","Wombourne South East",3883,1874,2009,3871,12,40
"41UFJN","Wombourne South West",4739,2377,2362,4714,25,36
"41UGGH","Barlaston and Oulton",3906,1862,2044,3781,125,57
"41UGGJ","Baswich",3802,1854,1948,3802,0,55
"41UGGK","Chartley",1726,861,865,1726,0,52
"41UGGL","Church Eaton",2032,1000,1032,2032,0,36
"41UGGM","Common",4102,2036,2066,4053,49,23
"41UGGN","Coton",4014,2042,1972,4014,0,16
"41UGGP","Eccleshall",6313,3025,3288,6086,227,122
"41UGGQ","Forebridge",4117,2090,2027,4039,78,38
"41UGGR","Fulford",5579,2730,2849,5478,101,59
"41UGGS","Gnosall and Woodseaves",6346,3175,3171,6334,12,109
"41UGGT","Haywood and Hixon",6297,3121,3176,6186,111,99
"41UGGU","Highfields and Western Downs",6635,3255,3380,6635,0,34
"41UGGW","Holmcroft",6641,3273,3368,6545,96,52
"41UGGX","Littleworth",6547,3493,3054,5951,596,51
"41UGGY","Manor",6022,2902,3120,5992,30,43
"41UGGZ","Milford",4013,2147,1866,3403,610,85
"41UGHA","Milwich",1801,890,911,1736,65,33
"41UGHB","Penkside",3570,1782,1788,3570,0,21
"41UGHC","Rowley",4458,2142,2316,4200,258,72
"41UGHD","St. Michael's",4851,2400,2451,4851,0,61
"41UGHE","Seighford",3376,1680,1696,3313,63,51
"41UGHF","Stonefield and Christchurch",4253,2014,2239,4143,110,41
"41UGHG","Swynnerton",4233,2081,2152,4221,12,80
"41UGHH","Tillington",4059,1945,2114,4059,0,33
"41UGHJ","Walton",5451,2687,2764,5354,97,54
"41UGHK","Weeping Cross",6526,3269,3257,6526,0,135
"41UHGF","Alton",1396,695,701,1392,4,28
"41UHGG","Bagnall and Stanley",1481,739,742,1481,0,24
"41UHGH","Biddulph East",5996,2874,3122,5918,78,16
"41UHGJ","Biddulph Moor",1689,844,845,1689,0,30
"41UHGK","Biddulph North",5122,2550,2572,5122,0,61
"41UHGL","Biddulph South",1626,786,840,1581,45,8
"41UHGM","Biddulph West",5079,2503,2576,5079,0,36
"41UHGN","Brown Edge and Endon",4759,2309,2450,4711,48,47
"41UHGP","Caverswall",1707,874,833,1675,32,12
"41UHGQ","Cellarhead",3342,1671,1671,3256,86,17
"41UHGR","Cheadle North East",3581,1789,1792,3540,41,11
"41UHGS","Cheadle South East",3664,1793,1871,3600,64,26
"41UHGT","Cheadle West",4921,2381,2540,4786,135,46
"41UHGU","Checkley",5402,2671,2731,5385,17,54
"41UHGW","Cheddleton",4474,2194,2280,4331,143,50
"41UHGX","Churnet",3226,1584,1642,3159,67,22
"41UHGY","Dane",1586,789,797,1565,21,21
"41UHGZ","Forsbrook",5008,2487,2521,5008,0,46
"41UHHA","Hamps Valley",1685,856,829,1667,18,35
"41UHHB","Horton",1784,913,871,1741,43,32
"41UHHC","Ipstones",1817,902,915,1817,0,19
"41UHHD","Leek East",4645,2263,2382,4513,132,46
"41UHHE","Leek North",5412,2618,2794,5303,109,24
"41UHHF","Leek South",5093,2477,2616,5035,58,60
"41UHHG","Leek West",4730,2302,2428,4703,27,72
"41UHHH","Manifold",1834,928,906,1834,0,19
"41UHHJ","Werrington",3430,1695,1735,3387,43,29
"41UKFL","Amington",8206,4068,4138,8200,6,50
"41UKFM","Belgrave",7546,3746,3800,7470,76,40
"41UKFN","Bolehall",6874,3355,3519,6839,35,38
"41UKFP","Castle",6869,3370,3499,6859,10,38
"41UKFQ","Glascote",8344,4035,4309,8344,0,32
"41UKFR","Mercian",6771,3310,3461,6723,48,54
"41UKFS","Spital",6608,3185,3423,6469,139,75
"41UKFT","Stonydelph",8073,3962,4111,8059,14,48
"41UKFU","Trinity",7119,3611,3508,7115,4,54
"41UKFW","Wilnecote",8121,4057,4064,8121,0,67
"42UBGH","Alton",3854,1858,1996,3854,0,62
"42UBGJ","Berners",3867,1879,1988,3840,27,45
"42UBGK","Boxford",2116,1076,1040,2116,0,48
"42UBGL","Brett Vale",1949,962,987,1946,3,42
"42UBGM","Brook",3817,1874,1943,3691,126,60
"42UBGN","Bures St Mary",1701,841,860,1701,0,27
"42UBGP","Chadacre",1945,937,1008,1930,15,34
"42UBGQ","Dodnash",3416,1662,1754,3349,67,79
"42UBGR","Glemsford and Stanstead",3602,1832,1770,3592,10,25
"42UBGS","Great Cornard North",3898,1867,2031,3794,104,27
"42UBGT","Great Cornard South",4102,2049,2053,4094,8,42
"42UBGU","Hadleigh North",3417,1636,1781,3343,74,31
"42UBGW","Hadleigh South",3822,1839,1983,3819,3,54
"42UBGX","Holbrook",2593,1326,1267,1849,744,54
"42UBGY","Lavenham",1738,835,903,1727,11,26
"42UBGZ","Leavenheath",1744,862,882,1744,0,34
"42UBHA","Long Melford",3675,1791,1884,3625,50,36
"42UBHB","Lower Brett",2069,1025,1044,2061,8,65
"42UBHC","Mid Samford",4088,1994,2094,4088,0,95
"42UBHD","Nayland",1864,887,977,1831,33,42
"42UBHE","North Cosford",2119,1042,1077,2095,24,52
"42UBHF","Pinewood",4013,1957,2056,4013,0,24
"42UBHG","South Cosford",2139,1094,1045,2139,0,29
"42UBHH","Sudbury East",3954,1892,2062,3920,34,18
"42UBHJ","Sudbury North",4115,1969,2146,4067,48,27
"42UBHK","Sudbury South",3864,1799,2065,3686,178,24
"42UBHL","Waldingfield",3980,1953,2027,3955,25,66
"42UCFR","All Saints",3261,1593,1668,3257,4,29
"42UCFS","Brandon East",5173,2541,2632,5163,10,22
"42UCFT","Brandon West",3576,1781,1795,3529,47,7
"42UCFU","Eriswell and The Rows",10031,5389,4642,8845,1186,59
"42UCFW","Exning",1944,932,1012,1908,36,25
"42UCFX","Great Heath",4708,2341,2367,4700,8,20
"42UCFY","Iceni",1808,903,905,1808,0,26
"42UCFZ","Lakenheath",4490,2253,2237,4469,21,43
"42UCGA","Manor",1712,827,885,1697,15,18
"42UCGB","Market",3653,1773,1880,3627,26,23
"42UCGC","Red Lodge",1796,933,863,1796,0,10
"42UCGD","St Mary's",5537,2667,2870,5421,116,56
"42UCGE","Severals",6197,3170,3027,6033,164,41
"42UCGF","South",1624,804,820,1624,0,32
"42UDFS","Alexandra",7112,3669,3443,6930,182,52
"42UDFT","Bixley",7198,3512,3686,7055,143,116
"42UDFU","Bridge",7226,3569,3657,7006,220,36
"42UDFW","Castle Hill",7528,3655,3873,7505,23,94
"42UDFX","Gainsborough",8380,3998,4382,8373,7,26
"42UDFY","Gipping",7624,3804,3820,7515,109,43
"42UDFZ","Holywells",5629,2758,2871,5571,58,51
"42UDGA","Priory Heath",6426,3146,3280,6411,15,25
"42UDGB","Rushmere",7995,3840,4155,7945,50,76
"42UDGC","St John's",7245,3481,3764,7070,175,62
"42UDGD","St Margaret's",7290,3521,3769,7008,282,153
"42UDGE","Sprites",7008,3429,3579,6985,23,35
"42UDGF","Stoke Park",7235,3589,3646,7162,73,42
"42UDGG","Westgate",7558,3896,3662,7339,219,60
"42UDGH","Whitehouse",7467,3613,3854,7463,4,38
"42UDGJ","Whitton",8148,3914,4234,8136,12,54
"42UEGM","Bacton and Old Newton",2294,1163,1131,2281,13,27
"42UEGN","Badwell Ash",2487,1208,1279,2436,51,56
"42UEGP","Barking and Somersham",2126,1058,1068,2108,18,32
"42UEGQ","Bramford and Blakenham",3850,1941,1909,3842,8,46
"42UEGR","Claydon and Barham",4200,2086,2114,4113,87,55
"42UEGS","Debenham",2076,982,1094,2063,13,37
"42UEGT","Elmswell and Norton",4560,2256,2304,4560,0,61
"42UEGU","Eye",2000,960,1040,1893,107,24
"42UEGW","Fressingfield",2148,1072,1076,2148,0,25
"42UEGX","Gislingham",2259,1163,1096,2239,20,32
"42UEGY","Haughley and Wetherden",2107,1036,1071,2082,25,24
"42UEGZ","Helmingham and Coddenham",2034,1061,973,2034,0,43
"42UEHA","Hoxne",1932,956,976,1903,29,46
"42UEHB","Mendlesham",2118,1060,1058,2118,0,43
"42UEHC","Needham Market",4574,2236,2338,4522,52,39
"42UEHD","Onehouse",2317,1126,1191,2059,258,39
"42UEHE","Palgrave",1939,966,973,1904,35,37
"42UEHF","Rattlesden",1840,913,927,1840,0,42
"42UEHG","Rickinghall and Walsham",4262,2118,2144,4262,0,49
"42UEHH","Ringshall",3053,1761,1292,2584,469,59
"42UEHJ","Stowmarket Central",4323,2093,2230,4245,78,50
"42UEHK","Stowmarket North",5883,2890,2993,5792,91,41
"42UEHL","Stowmarket South",5042,2469,2573,5008,34,41
"42UEHM","Stowupland",2207,1101,1106,2207,0,17
"42UEHN","Stradbroke and Laxfield",2324,1160,1164,2324,0,12
"42UEHP","The Stonhams",2167,1100,1067,2167,0,35
"42UEHQ","Thurston and Hessett",4309,2129,2180,4309,0,83
"42UEHR","Wetheringsett",2283,1150,1133,2283,0,22
"42UEHS","Woolpit",1968,956,1012,1962,6,29
"42UEHT","Worlingworth",2155,1084,1071,2155,0,28
"42UFGL","Abbeygate",4280,2071,2209,4143,137,53
"42UFGM","Bardwell",2376,1238,1138,2291,85,46
"42UFGN","Barningham",2541,1247,1294,2541,0,31
"42UFGP","Barrow",2069,1007,1062,2044,25,46
"42UFGQ","Cavendish",1845,884,961,1806,39,26
"42UFGR","Chedburgh",2175,1082,1093,2142,33,45
"42UFGS","Clare",1975,975,1000,1966,9,26
"42UFGT","Eastgate",2038,892,1146,1849,189,25
"42UFGU","Fornham",2040,977,1063,1945,95,33
"42UFGW","Great Barton",2085,1044,1041,2071,14,62
"42UFGX","Haverhill East",6663,3296,3367,6660,3,32
"42UFGY","Haverhill North",6243,3001,3242,6209,34,49
"42UFGZ","Haverhill South",4512,2197,2315,4512,0,32
"42UFHA","Haverhill West",4592,2311,2281,4586,6,15
"42UFHB","Horringer and Whelnetham",2076,1005,1071,2076,0,32
"42UFHC","Hundon",2098,1040,1058,2089,9,24
"42UFHD","Ixworth",2233,1062,1171,2159,74,43
"42UFHE","Kedington",2021,1006,1015,1947,74,19
"42UFHF","Minden",4544,2239,2305,4539,5,46
"42UFHG","Moreton Hall",5266,2657,2609,5249,17,62
"42UFHH","Northgate",2427,1156,1271,2426,0,13
"42UFHJ","Pakenham",3023,1791,1232,2466,557,48
"42UFHK","Risby",2628,1323,1305,2293,335,55
"42UFHL","Risbygate",3725,1845,1880,3640,85,45
"42UFHM","Rougham",2187,1085,1102,2174,13,38
"42UFHN","St Olaves",4688,2284,2404,4682,6,14
"42UFHP","Southgate",4243,2107,2136,4178,65,73
"42UFHQ","Stanton",2683,1331,1352,2661,22,21
"42UFHR","Westgate",4262,2066,2196,4169,93,65
"42UFHS","Wickhambrook",1992,969,1023,1966,26,42
"42UFHT","Withersfield",2663,1498,1165,1938,725,34
"42UGGW","Aldeburgh",3538,1606,1932,3437,101,43
"42UGGX","Earl Soham",2051,1005,1046,2051,0,74
"42UGGY","Farlingaye",2052,1001,1051,2004,48,21
"42UGGZ","Felixstowe East",4005,1924,2081,4005,0,75
"42UGHA","Felixstowe North",4299,2023,2276,4299,0,39
"42UGHB","Felixstowe South",4362,2040,2322,4071,291,45
"42UGHC","Felixstowe South East",4684,2145,2539,4475,209,91
"42UGHD","Felixstowe West",6702,3236,3466,6642,60,41
"42UGHE","Framlingham",4488,2182,2306,4140,348,107
"42UGHF","Grundisburgh",2251,1099,1152,2251,0,60
"42UGHG","Hacheston",2006,974,1032,2006,0,56
"42UGHH","Hollesley with Eyke",2314,1257,1057,2108,206,23
"42UGHJ","Kesgrave East",5729,2816,2913,5706,23,46
"42UGHK","Kesgrave West",3547,1705,1842,3547,0,19
"42UGHL","Kyson",2049,964,1085,2000,49,30
"42UGHM","Leiston",6240,3019,3221,6152,88,62
"42UGHN","Martlesham",4926,2489,2437,4926,0,70
"42UGHP","Melton and Ufford",4731,2278,2453,4731,0,95
"42UGHQ","Nacton",4237,2094,2143,4221,16,68
"42UGHR","Orford and Tunstall",1855,927,928,1849,6,44
"42UGHS","Otley",2186,1108,1078,2186,0,59
"42UGHT","Peasenhall",2045,1024,1021,2045,0,38
"42UGHU","Rendlesham",1977,950,1027,1959,18,17
"42UGHW","Riverside",1840,855,985,1779,61,39
"42UGHX","Rushmere St Andrew",6062,2990,3072,6054,8,78
"42UGHY","Saxmundham",3992,1888,2104,3948,44,30
"42UGHZ","Seckford",1752,766,986,1724,28,38
"42UGJA","Snape",1914,953,961,1911,3,32
"42UGJB","Sutton",2412,1234,1178,2353,59,55
"42UGJC","Trimleys with Kirton",6883,3377,3506,6866,17,95
"42UGJD","Walberswick and Wenhaston",1995,964,1031,1992,3,18
"42UGJE","Wickham Market",2204,1044,1160,2170,34,23
"42UGJF","Witnesham",1951,958,993,1921,30,47
"42UGJG","Yoxford",1862,905,957,1808,54,42
"42UHFY","Beccles North",4650,2141,2509,4529,121,49
"42UHFZ","Beccles South",5096,2503,2593,5070,26,31
"42UHGA","Blything",2206,1097,1109,2206,0,38
"42UHGB","Bungay",4895,2313,2582,4769,126,49
"42UHGC","Carlton",4720,2289,2431,4698,22,40
"42UHGD","Carlton Colville",6612,3254,3358,6551,61,55
"42UHGE","Gunton and Corton",4545,2223,2322,4488,57,68
"42UHGF","Halesworth",4637,2163,2474,4562,75,32
"42UHGG","Harbour",7808,3774,4034,7716,92,36
"42UHGH","Kessingland",4760,2294,2466,4719,41,37
"42UHGJ","Kirkley",7304,3497,3807,7032,272,36
"42UHGK","Lothingland",2540,1443,1097,2128,412,26
"42UHGL","Normanston",7218,3498,3720,7197,21,25
"42UHGM","Oulton",4311,2093,2218,4311,0,49
"42UHGN","Oulton Broad",4603,2210,2393,4523,80,47
"42UHGP","Pakefield",6901,3246,3655,6865,36,49
"42UHGQ","St Margaret's",7106,3381,3725,7072,34,41
"42UHGR","Southwold and Reydon",4025,1776,2249,3838,187,56
"42UHGS","The Saints",2194,1108,1086,2194,0,46
"42UHGT","Wainford",2241,1111,1130,2241,0,48
"42UHGU","Whitton",7483,3549,3934,7483,0,39
"42UHGW","Worlingham",4252,2074,2178,4252,0,58
"42UHGX","Wrentham",2235,1084,1151,2232,3,40
"43UBFZ","Claygate",6492,3108,3384,6417,75,152
"43UBGA","Cobham and Downside",6158,2918,3240,6017,141,142
"43UBGB","Cobham Fairmile",4760,2433,2327,4537,223,124
"43UBGC","Esher",6280,3026,3254,6173,107,211
"43UBGD","Hersham North",5809,2750,3059,5778,31,58
"43UBGE","Hersham South",6104,2844,3260,5981,123,122
"43UBGF","Hinchley Wood",3975,1937,2038,3962,13,77
"43UBGG","Long Ditton",5830,2816,3014,5830,0,94
"43UBGH","Molesey East",6097,2957,3140,5989,108,116
"43UBGJ","Molesey North",5985,2886,3099,5985,0,80
"43UBGK","Molesey South",6483,3157,3326,6418,65,51
"43UBGL","Oatlands Park",5663,2687,2976,5597,66,109
"43UBGM","Oxshott and Stoke D'Abernon",6100,2981,3119,6069,31,229
"43UBGN","St George's Hill",5884,2833,3051,5777,107,149
"43UBGP","Thames Ditton",5863,2814,3049,5715,148,106
"43UBGQ","Walton Ambleside",4106,2022,2084,4059,47,32
"43UBGR","Walton Central",5862,2791,3071,5850,12,113
"43UBGS","Walton North",6650,3224,3426,6650,0,42
"43UBGT","Walton South",6216,2994,3222,6112,104,116
"43UBGU","Weston Green",3703,1809,1894,3687,16,72
"43UBGW","Weybridge North",4078,1989,2089,3970,108,59
"43UBGX","Weybridge South",3838,1891,1947,3785,53,72
"43UCFP","Auriol",3687,1829,1858,3674,13,58
"43UCFQ","College",5372,2638,2734,4945,427,137
"43UCFR","Court",5049,2501,2548,4765,284,26
"43UCFS","Cuddington",5791,2796,2995,5791,0,76
"43UCFT","Ewell",4851,2273,2578,4767,84,47
"43UCFU","Ewell Court",5127,2528,2599,5127,0,44
"43UCFW","Nonsuch",5194,2566,2628,5162,32,149
"43UCFX","Ruxley",5198,2460,2738,5184,14,36
"43UCFY","Stamford",5758,2787,2971,5566,192,94
"43UCFZ","Stoneleigh",4700,2322,2378,4695,5,85
"43UCGA","Town",5347,2452,2895,5278,69,55
"43UCGB","West Ewell",5648,2739,2909,5629,19,58
"43UCGC","Woodcote",5337,2536,2801,5257,80,105
"43UDFY","Ash South and Tongham",8005,3948,4057,7994,11,65
"43UDFZ","Ash Vale",5807,2962,2845,5645,162,55
"43UDGA","Ash Wharf",6073,2991,3082,6031,42,51
"43UDGB","Burpham",5221,2547,2674,5197,24,103
"43UDGC","Christchurch",4668,2175,2493,4596,72,179
"43UDGD","Clandon and Horsley",8409,4051,4358,8288,121,273
"43UDGE","Effingham",2556,1198,1358,2467,89,51
"43UDGF","Friary and St Nicolas",7907,3995,3912,7629,278,88
"43UDGG","Holy Trinity",7068,3488,3580,6974,94,149
"43UDGH","Lovelace",2629,1196,1433,2388,241,43
"43UDGJ","Merrow",7706,3737,3969,7659,47,159
"43UDGK","Normandy",2987,1491,1496,2987,0,58
"43UDGL","Onslow",8184,3876,4308,5507,2677,118
"43UDGM","Pilgrims",2508,1248,1260,2344,164,67
"43UDGN","Pirbright",4214,2572,1642,3043,1171,74
"43UDGP","Send",4138,2053,2085,4096,42,91
"43UDGQ","Shalford",5161,2373,2788,5002,159,104
"43UDGR","Stoke",5858,2919,2939,5858,0,33
"43UDGS","Stoughton",8027,4034,3993,8027,0,88
"43UDGT","Tillingbourne",5216,2543,2673,5200,16,110
"43UDGU","Westborough",9080,4494,4586,9080,0,85
"43UDGW","Worplesdon",8279,4095,4184,8167,112,108
"43UEGA","Ashtead Common",4040,1973,2067,4022,18,70
"43UEGB","Ashtead Park",3796,1803,1993,3713,83,109
"43UEGC","Ashtead Village",5658,2649,3009,5528,130,125
"43UEGD","Beare Green",1863,937,926,1863,0,31
"43UEGE","Bookham North",5616,2679,2937,5548,68,113
"43UEGF","Bookham South",5391,2556,2835,5340,51,106
"43UEGG","Box Hill and Headley",2122,1066,1056,2095,27,21
"43UEGH","Brockham, Betchworth and Buckland",4302,2083,2219,4206,96,71
"43UEGJ","Capel, Leigh and Newdigate",3882,1921,1961,3882,0,71
"43UEGK","Charlwood",2027,995,1032,1963,64,27
"43UEGL","Dorking North",3917,1851,2066,3899,18,48
"43UEGM","Dorking South",6457,3114,3343,6291,166,121
"43UEGN","Fetcham East",3676,1814,1862,3663,13,71
"43UEGP","Fetcham West",4069,2006,2063,3996,73,66
"43UEGQ","Holmwoods",6136,2988,3148,6058,78,59
"43UEGR","Leatherhead North",5848,2890,2958,5773,75,48
"43UEGS","Leatherhead South",3837,1890,1947,3623,214,66
"43UEGT","Leith Hill",1733,892,841,1698,35,60
"43UEGU","Mickleham, Westhumble and Pixham",1932,934,998,1769,163,34
"43UEGW","Okewood",1843,927,916,1837,6,43
"43UEGX","Westcott",2142,1020,1122,2078,64,49
"43UFFU","Banstead Village",8510,4365,4145,7473,1037,113
"43UFFW","Chipstead, Hooley and Woodmansterne",6912,3465,3447,6774,138,103
"43UFFX","Earlswood and Whitebushes",8234,4097,4137,8145,89,68
"43UFFY","Horley Central",7722,3765,3957,7492,230,67
"43UFFZ","Horley East",5445,2725,2720,5429,16,79
"43UFGA","Horley West",8065,3958,4107,8060,5,85
"43UFGB","Kingswood with Burgh Heath",6219,3036,3183,6081,138,102
"43UFGC","Meadvale and St John's",7466,3659,3807,7431,35,157
"43UFGD","Merstham",7385,3584,3801,7312,73,79
"43UFGE","Nork",7351,3594,3757,7273,78,114
"43UFGF","Preston",2998,1405,1593,2998,0,15
"43UFGG","Redhill East",6822,3469,3353,6712,110,82
"43UFGH","Redhill West",7424,3654,3770,7378,46,106
"43UFGJ","Reigate Central",6736,3202,3534,6460,276,142
"43UFGK","Reigate Hill",5315,2581,2734,4631,684,114
"43UFGL","Salfords and Sidlow",2484,1267,1217,2464,20,36
"43UFGM","South Park and Woodhatch",7145,3460,3685,7102,43,90
"43UFGN","Tadworth and Walton",7016,3320,3696,6792,224,141
"43UFGP","Tattenhams",7274,3494,3780,7252,22,65
"43UGFQ","Addlestone Bourneside",5211,2506,2705,5211,0,39
"43UGFR","Addlestone North",5500,2698,2802,5434,66,39
"43UGFS","Chertsey Meads",5359,2680,2679,5347,12,40
"43UGFT","Chertsey St Ann's",5483,2648,2835,5374,109,40
"43UGFU","Chertsey South and Row Town",5227,2546,2681,5098,129,50
"43UGFW","Egham Hythe",6345,3155,3190,6334,11,34
"43UGFX","Egham Town",5724,2809,2915,5705,19,40
"43UGFY","Englefield Green East",5692,2490,3202,2934,2758,41
"43UGFZ","Englefield Green West",5488,2692,2796,5041,447,58
"43UGGA","Foxhills",5467,2645,2822,5321,146,78
"43UGGB","New Haw",5646,2776,2870,5606,40,44
"43UGGC","Thorpe",5624,2822,2802,5586,38,87
"43UGGD","Virginia Water",5895,2853,3042,5805,90,133
"43UGGE","Woodham",5372,2655,2717,5366,6,97
"43UHFS","Ashford Common",7671,3774,3897,7671,0,43
"43UHFT","Ashford East",6958,3405,3553,6943,15,53
"43UHFU","Ashford North and Stanwell South",7553,3704,3849,7427,126,40
"43UHFW","Ashford Town",6772,3323,3449,6689,83,59
"43UHFX","Halliford and Sunbury West",5969,2874,3095,5869,100,61
"43UHFY","Laleham and Shepperton Green",7256,3541,3715,7208,48,58
"43UHFZ","Riverside and Laleham",6617,3290,3327,6615,0,63
"43UHGA","Shepperton Town",6463,3171,3292,6378,85,70
"43UHGB","Staines",7302,3626,3676,7234,68,62
"43UHGC","Staines South",6739,3233,3506,6686,53,40
"43UHGD","Stanwell North",7301,3580,3721,7295,6,41
"43UHGE","Sunbury Common",7481,3666,3815,7438,43,41
"43UHGF","Sunbury East",6308,3163,3145,6290,18,95
"43UJFS","Bagshot",5365,2663,2702,5334,31,59
"43UJFT","Bisley",3615,1921,1694,3341,274,61
"43UJFU","Chobham",3800,1819,1981,3738,62,90
"43UJFW","Frimley",5903,2891,3012,5799,104,89
"43UJFX","Frimley Green",5639,2781,2858,5635,4,107
"43UJFY","Heatherside",5921,2928,2993,5911,10,138
"43UJFZ","Lightwater",6691,3287,3404,6652,39,135
"43UJGA","Mytchett and Deepcut",6197,3177,3020,5862,335,102
"43UJGB","Old Dean",4277,2083,2194,4277,0,14
"43UJGC","Parkside",5947,2939,3008,5908,39,143
"43UJGD","St Michaels",4309,2108,2201,4214,95,57
"43UJGE","St Pauls",5419,2654,2765,5314,105,182
"43UJGF","Town",3967,1892,2075,3701,266,110
"43UJGG","Watchetts",4616,2252,2364,4528,88,92
"43UJGH","West End",4272,2115,2157,4189,83,89
"43UJGJ","Windlesham",4376,2191,2185,4288,88,123
"43UKFY","Bletchingley and Nutfield",5875,2888,2987,5717,158,97
"43UKFZ","Burstow, Horne and Outwood",5675,2800,2875,5594,81,72
"43UKGA","Chaldon",1821,887,934,1749,72,30
"43UKGB","Dormansland and Felcourt",3863,1898,1965,3542,321,96
"43UKGC","Felbridge",2039,970,1069,2022,17,52
"43UKGD","Godstone",5847,2803,3044,5790,57,77
"43UKGE","Harestone",3846,1947,1899,3659,187,85
"43UKGF","Limpsfield",3680,1738,1942,3593,87,129
"43UKGG","Lingfield and Crowhurst",4021,1939,2082,3957,64,55
"43UKGH","Oxted North and Tandridge",5607,2675,2932,5545,62,125
"43UKGJ","Oxted South",5891,2834,3057,5853,38,91
"43UKGK","Portley",4216,2040,2176,4113,103,37
"43UKGL","Queens Park",3723,1772,1951,3590,133,47
"43UKGM","Tatsfield and Titsey",1816,885,931,1816,0,34
"43UKGN","Valley",3735,1771,1964,3728,7,32
"43UKGP","Warlingham East and Chelsham and Farleigh",4997,2373,2624,4967,30,49
"43UKGQ","Warlingham West",3358,1627,1731,3330,28,73
"43UKGR","Westway",3616,1740,1876,3451,165,33
"43UKGS","Whyteleafe",3315,1638,1677,3291,24,34
"43UKGT","Woldingham",2326,938,1388,1887,439,78
"43ULGF","Alfold, Cranleigh Rural and Ellens Green",1789,856,933,1765,24,30
"43ULGG","Blackheath and Wonersh",1800,896,904,1758,42,49
"43ULGH","Bramley, Busbridge and Hascombe",4373,2009,2364,4133,240,110
"43ULGJ","Chiddingfold and Dunsfold",3812,1854,1958,3756,56,136
"43ULGK","Cranleigh East",6413,3118,3295,6348,65,128
"43ULGL","Cranleigh West",4021,2033,1988,3549,472,110
"43ULGM","Elstead and Thursley",3752,1824,1928,3723,29,119
"43ULGN","Ewhurst",2119,975,1144,1836,283,55
"43ULGP","Farnham Bourne",3835,1855,1980,3803,32,144
"43ULGQ","Farnham Castle",4070,1863,2207,3623,447,32
"43ULGR","Farnham Firgrove",4065,1902,2163,4004,61,92
"43ULGS","Farnham Hale and Heath End",4270,2116,2154,4269,3,50
"43ULGT","Farnham Moor Park",4361,2070,2291,4258,103,109
"43ULGU","Farnham Shortheath and Boundstone",3896,1927,1969,3891,5,76
"43ULGW","Farnham Upper Hale",4241,2085,2156,4241,0,65
"43ULGX","Farnham Weybourne and Badshot Lea",4176,2056,2120,4176,0,52
"43ULGY","Farnham Wrecclesham and Rowledge",4141,2038,2103,3967,174,86
"43ULGZ","Frensham, Dockenfield and Tilford",3961,1923,2038,3814,147,133
"43ULHA","Godalming Binscombe",4256,2075,2181,4256,0,36
"43ULHB","Godalming Central and Ockford",4284,2087,2197,4162,122,45
"43ULHC","Godalming Charterhouse",4053,2253,1800,3413,640,97
"43ULHD","Godalming Farncombe and Catteshall",4422,2101,2321,4383,39,43
"43ULHE","Godalming Holloway",4088,2017,2071,4030,58,133
"43ULHF","Haslemere Critchmere and Shottermill",5769,2695,3074,5457,312,87
"43ULHG","Haslemere East and Grayswood",5969,2803,3166,5905,64,208
"43ULHH","Hindhead",3874,1908,1966,3484,390,105
"43ULHJ","Milford",3934,1876,2058,3923,11,61
"43ULHK","Shamley Green and Cranleigh North",1833,881,952,1795,38,47
"43ULHL","Witley and Hambledon",4088,2003,2085,3688,400,102
"43UMFS","Brookwood",2416,1210,1206,2392,24,56
"43UMFT","Byfleet",6995,3413,3582,6978,17,67
"43UMFU","Goldsworth East",7325,3494,3831,7325,0,91
"43UMFW","Goldsworth West",5297,2622,2675,5290,7,60
"43UMFX","Hermitage and Knaphill South",5193,2579,2614,5193,0,60
"43UMFY","Horsell East and Woodham",4326,2098,2228,4224,102,108
"43UMFZ","Horsell West",6839,3330,3509,6806,33,140
"43UMGA","Kingfield and Westfield",5211,2487,2724,5165,46,57
"43UMGB","Knaphill",8635,4288,4347,8594,41,99
"43UMGC","Maybury and Sheerwater",8974,4448,4526,8970,4,87
"43UMGD","Mayford and Sutton Green",2369,1174,1195,2346,23,63
"43UMGE","Mount Hermon East",4621,2265,2356,4418,203,103
"43UMGF","Mount Hermon West",4487,2174,2313,4437,50,58
"43UMGG","Old Woking",2644,1326,1318,2644,0,14
"43UMGH","Pyrford",5076,2482,2594,5012,64,125
"43UMGJ","St John's and Hook Heath",4378,2108,2270,4286,92,137
"43UMGK","West Byfleet",5054,2371,2683,5020,34,167
"44UBFW","Arley and Whitacre",5444,2690,2754,5444,0,32
"44UBFX","Atherstone Central",3448,1682,1766,3419,29,7
"44UBFY","Atherstone North",3585,1737,1848,3550,35,21
"44UBFZ","Atherstone South and Mancetter",3754,1831,1923,3754,0,37
"44UBGA","Baddesley and Grendon",3951,1944,2007,3897,54,23
"44UBGB","Coleshill North",3153,1564,1589,3153,0,16
"44UBGC","Coleshill South",3190,1553,1637,3120,70,27
"44UBGD","Curdworth",3360,1693,1667,3356,4,66
"44UBGE","Dordon",3225,1580,1645,3215,10,11
"44UBGF","Fillongley",3393,1710,1683,3337,56,40
"44UBGG","Hartshill",3746,1805,1941,3698,48,18
"44UBGH","Hurley and Wood End",3642,1822,1820,3642,0,19
"44UBGJ","Kingsbury",3779,1867,1912,3779,0,31
"44UBGK","Newton Regis and Warton",3625,1777,1848,3569,56,39
"44UBGL","Polesworth East",3441,1693,1748,3423,18,17
"44UBGM","Polesworth West",3551,1794,1757,3546,5,32
"44UBGN","Water Orton",3573,1715,1858,3552,21,31
"44UCFR","Abbey",7234,3503,3731,7177,57,46
"44UCFS","Arbury",5482,2689,2793,5390,92,24
"44UCFT","Attleborough",7564,3623,3941,7494,70,38
"44UCFU","Bar Pool",7451,3707,3744,7448,3,23
"44UCFW","Bede",6760,3256,3504,6724,36,40
"44UCFX","Bulkington",6303,3089,3214,6281,22,72
"44UCFY","Camp Hill",7325,3536,3789,7294,31,29
"44UCFZ","Exhall",7381,3636,3745,7207,174,41
"44UCGA","Galley Common",7593,3886,3707,7593,0,42
"44UCGB","Heath",6377,3097,3280,6324,53,21
"44UCGC","Kingswood",6878,3401,3477,6868,10,29
"44UCGD","Poplar",6850,3435,3415,6850,0,48
"44UCGE","St Nicolas",7073,3516,3557,7000,73,126
"44UCGF","Slough",7058,3496,3562,7005,53,49
"44UCGG","Weddington",7286,3564,3722,7270,16,95
"44UCGH","Wem Brook",7082,3385,3697,7018,64,35
"44UCGJ","Whitestone",7435,3700,3735,7433,3,117
"44UDFZ","Admirals",4743,2367,2376,4743,0,48
"44UDGA","Avon and Swift",2555,1256,1299,2393,162,35
"44UDGB","Benn",6265,3187,3078,6236,29,69
"44UDGC","Bilton",4991,2376,2615,4898,93,77
"44UDGD","Brownsover North",4074,2046,2028,4074,0,50
"44UDGE","Brownsover South",4147,2025,2122,4147,0,16
"44UDGF","Caldecott",5595,2809,2786,4914,681,94
"44UDGG","Dunchurch and Knightlow",5432,2643,2789,5353,79,109
"44UDGH","Earl Craven and Wolston",5552,2748,2804,5491,61,74
"44UDGJ","Eastlands",5381,2661,2720,5381,0,62
"44UDGK","Fosse",3545,1774,1771,3545,0,42
"44UDGL","Hillmorton",5183,2505,2678,5124,59,38
"44UDGM","Lawford and King's Newnham",3231,1604,1627,3231,0,23
"44UDGN","Leam Valley",1820,897,923,1808,12,52
"44UDGP","New Bilton",5689,2828,2861,5645,44,57
"44UDGQ","Newbold",5996,2922,3074,5961,35,52
"44UDGR","Overslade",5606,2743,2863,5520,86,45
"44UDGS","Paddox",3714,1855,1859,3714,0,44
"44UDGT","Ryton-on-Dunsmore",1672,859,813,1651,21,19
"44UDGU","Wolvey",2262,1246,1016,2010,252,42
"44UEGN","Alcester",6129,2902,3227,6078,51,60
"44UEGP","Aston Cantlow",1930,944,986,1920,10,23
"44UEGQ","Bardon",1796,866,930,1796,0,40
"44UEGR","Bidford and Salford",6446,3104,3342,6307,139,68
"44UEGS","Brailes",2062,1003,1059,2057,5,43
"44UEGT","Burton Dassett",2044,1019,1025,2041,3,53
"44UEGU","Claverdon",2246,1073,1173,2190,56,47
"44UEGW","Ettington",2057,1005,1052,2039,18,49
"44UEGX","Fenny Compton",2385,1172,1213,2385,0,63
"44UEGY","Harbury",4617,2280,2337,4608,9,73
"44UEGZ","Henley",4176,1990,2186,4165,11,48
"44UEHA","Kineton",4228,2048,2180,4136,92,74
"44UEHB","Kinwarton",2061,1046,1015,2061,0,48
"44UEHC","Long Compton",1994,979,1015,1994,0,53
"44UEHD","Long Itchington",2400,1196,1204,2328,72,36
"44UEHE","Quinton",2233,1075,1158,2205,28,30
"44UEHF","Sambourne",1805,879,926,1771,34,21
"44UEHG","Shipston",4456,2105,2351,4424,32,43
"44UEHH","Snitterfield",2251,1093,1158,2219,32,45
"44UEHJ","Southam",6509,3160,3349,6473,36,55
"44UEHK","Stockton and Napton",2449,1243,1206,2435,14,27
"44UEHL","Stratford Alveston",5202,2501,2701,5120,82,128
"44UEHM","Stratford Avenue and New Town",6362,3023,3339,6187,175,85
"44UEHN","Stratford Guild and Hathaway",6303,2924,3379,6140,163,116
"44UEHP","Stratford Mount Pleasant",4277,2099,2178,4239,38,48
"44UEHQ","Studley",5939,2889,3050,5885,54,63
"44UEHR","Tanworth",3725,1852,1873,3685,40,62
"44UEHS","Tredington",2360,1157,1203,2360,0,48
"44UEHT","Vale of the Red Horse",2237,1090,1147,2234,3,61
"44UEHU","Welford",2032,994,1038,2032,0,39
"44UEHW","Wellesbourne",6773,3264,3509,6604,169,94
"44UFFX","Abbey",7552,3671,3881,7481,71,143
"44UFFY","Bishop's Tachbrook",2514,1257,1257,2503,11,26
"44UFFZ","Brunswick",9299,4705,4594,9296,3,49
"44UFGA","Budbrooke",5223,2558,2665,5214,9,110
"44UFGB","Clarendon",4954,2459,2495,4913,41,87
"44UFGC","Crown",5829,2820,3009,5792,37,44
"44UFGD","Cubbington",5777,2855,2922,5706,71,97
"44UFGE","Lapworth",2870,1418,1452,2838,32,69
"44UFGF","Leek Wootton",2439,1236,1203,2432,7,62
"44UFGG","Manor",8162,3903,4259,7867,295,155
"44UFGH","Milverton",8269,4074,4195,7989,280,160
"44UFGJ","Park Hill",8124,3948,4176,8112,12,152
"44UFGK","Radford Semele",2494,1228,1266,2488,6,49
"44UFGL","St John's",7543,3642,3901,7487,56,148
"44UFGM","Stoneleigh",3049,1492,1557,2290,759,32
"44UFGN","Warwick North",8488,4206,4282,8437,51,112
"44UFGP","Warwick South",8569,4248,4321,8444,125,148
"44UFGQ","Warwick West",8377,3985,4392,8291,86,72
"44UFGR","Whitnash",7798,3836,3962,7741,57,83
"44UFGS","Willes",8601,4424,4177,8488,113,100
"45UBFQ","Buckingham",3921,1906,2015,3911,10,48
"45UBFR","Churchill",4392,2007,2385,4298,94,16
"45UBFS","Cokeham",4212,2078,2134,4188,24,26
"45UBFT","Eastbrook",4380,2075,2305,4348,32,23
"45UBFU","Hillside",4309,2058,2251,4264,45,13
"45UBFW","Manor",4296,2165,2131,4039,257,34
"45UBFX","Marine",3552,1744,1808,3549,3,38
"45UBFY","Mash Barn",4454,2100,2354,4453,0,22
"45UBFZ","Peverel",4302,2034,2268,4258,44,25
"45UBGA","St Mary's",3949,1866,2083,3811,138,25
"45UBGB","St Nicolas",3815,1803,2012,3759,56,63
"45UBGC","Southlands",3938,1842,2096,3924,14,17
"45UBGD","Southwick Green",4506,2125,2381,4418,88,45
"45UBGE","Widewater",5601,2601,3000,5519,82,28
"45UCGE","Aldwick East",4675,2150,2525,4587,88,62
"45UCGF","Aldwick West",4727,2162,2565,4672,55,58
"45UCGG","Angmering",5812,2729,3083,5812,0,69
"45UCGH","Arundel",4233,2016,2217,4162,71,71
"45UCGJ","Barnham",8091,3934,4157,7927,164,124
"45UCGK","Beach",4802,2301,2501,4635,167,67
"45UCGL","Bersted",8443,4096,4347,8406,37,34
"45UCGM","Brookfield",5587,2679,2908,5584,3,29
"45UCGN","East Preston with Kingston",7155,3276,3879,6954,201,80
"45UCGP","Felpham East",4846,2343,2503,4829,17,62
"45UCGQ","Felpham West",4875,2284,2591,4770,105,48
"45UCGR","Ferring",4361,1888,2473,4254,107,35
"45UCGS","Findon",2395,1113,1282,2340,55,30
"45UCGT","Ham",5737,2764,2973,5694,43,34
"45UCGU","Hotham",5851,2699,3152,4975,876,26
"45UCGW","Marine",4951,2284,2667,4432,519,36
"45UCGX","Middleton-on-Sea",5105,2373,2732,5083,22,54
"45UCGY","Orchard",6209,2968,3241,6105,104,35
"45UCGZ","Pagham and Rose Green",7211,3398,3813,7128,83,37
"45UCHA","Pevensey",5544,2538,3006,5323,221,47
"45UCHB","River",4708,2172,2536,4371,337,23
"45UCHC","Rustington East",4966,2209,2757,4870,96,56
"45UCHD","Rustington West",7710,3505,4205,7579,131,74
"45UCHE","Walberton",2636,1306,1330,2522,114,49
"45UCHF","Wick with Toddington",4759,2279,2480,4747,12,36
"45UCHG","Yapton",5370,2746,2624,5066,304,47
"45UDGM","Bosham",4097,1938,2159,4001,96,81
"45UDGN","Boxgrove",2148,1013,1135,2091,57,41
"45UDGP","Bury",2324,1136,1188,2106,218,73
"45UDGQ","Chichester East",7004,3261,3743,6975,29,66
"45UDGR","Chichester North",5849,2662,3187,5445,404,106
"45UDGS","Chichester South",6339,2864,3475,6011,328,65
"45UDGT","Chichester West",4539,2039,2500,4532,7,35
"45UDGU","Donnington",2135,984,1151,2091,44,31
"45UDGW","Easebourne",2407,1138,1269,2344,63,69
"45UDGX","East Wittering",4564,2154,2410,4441,123,45
"45UDGY","Fernhurst",4990,2425,2565,4816,174,148
"45UDGZ","Fishbourne",1953,924,1029,1899,54,28
"45UDHA","Funtington",2534,1227,1307,2514,20,75
"45UDHB","Harting",1988,970,1018,1976,12,73
"45UDHC","Lavant",2046,935,1111,1951,95,47
"45UDHD","Midhurst",4889,2154,2735,4802,87,72
"45UDHE","North Mundham",2193,1059,1134,2070,123,48
"45UDHF","Petworth",4528,2151,2377,4469,59,123
"45UDHG","Plaistow",4591,2303,2288,4550,41,138
"45UDHH","Rogate",2420,1179,1241,2388,32,98
"45UDHJ","Selsey North",5694,2623,3071,5611,83,22
"45UDHK","Selsey South",4181,1965,2216,4030,151,27
"45UDHL","Sidlesham",2253,1121,1132,2202,51,46
"45UDHM","Southbourne",7080,3533,3547,6621,459,80
"45UDHN","Stedham",2287,1084,1203,2246,41,80
"45UDHP","Tangmere",2462,1194,1268,2462,0,29
"45UDHQ","West Wittering",4543,2107,2436,4492,51,120
"45UDHR","Westbourne",2140,1038,1102,2133,7,34
"45UDHS","Wisborough Green",2272,1122,1150,2272,0,60
"45UEFP","Bewbush",9081,4463,4618,9057,24,63
"45UEFQ","Broadfield North",6340,3079,3261,6340,0,33
"45UEFR","Broadfield South",6326,3022,3304,6326,0,24
"45UEFS","Furnace Green",5734,2821,2913,5702,32,59
"45UEFT","Gossops Green",5014,2470,2544,5014,0,33
"45UEFU","Ifield",8414,4108,4306,8274,140,53
"45UEFW","Langley Green",7286,3667,3619,7263,23,67
"45UEFX","Maidenbower",8070,4048,4022,8070,0,27
"45UEFY","Northgate",4407,2164,2243,4395,12,25
"45UEFZ","Pound Hill North",6746,3330,3416,6745,0,96
"45UEGA","Pound Hill South and Worth",7970,3922,4048,7945,25,123
"45UEGB","Southgate",8106,3901,4205,7822,284,51
"45UEGC","Three Bridges",5648,2820,2828,5608,40,51
"45UEGD","Tilgate",6198,3011,3187,6198,0,40
"45UEGE","West Green",4404,2094,2310,4368,36,21
"45UFGC","Billingshurst and Shipley",7606,3704,3902,7545,61,169
"45UFGD","Bramber, Upper Beeding and Woodmancote",5235,2549,2686,5189,46,86
"45UFGE","Broadbridge Heath",3021,1499,1522,3021,0,24
"45UFGF","Chanctonbury",7681,3822,3859,7676,5,159
"45UFGG","Chantry",8751,4133,4618,8375,376,190
"45UFGH","Cowfold, Shermanbury and West Grinstead",5252,2594,2658,5153,99,92
"45UFGJ","Denne",4831,2315,2516,4799,32,68
"45UFGK","Forest",3469,1649,1820,3420,49,75
"45UFGL","Henfield",4810,2243,2567,4711,99,70
"45UFGM","Holbrook East",5648,2815,2833,5610,38,90
"45UFGN","Holbrook West",5394,2620,2774,5339,55,72
"45UFGP","Horsham Park",7548,3643,3905,7350,198,71
"45UFGQ","Itchingfield, Slinfold and Warnham",5082,2445,2637,4827,255,106
"45UFGR","Nuthurst",2712,1312,1400,2674,38,79
"45UFGS","Pulborough and Coldwatham",5530,2656,2874,5462,68,113
"45UFGT","Roffey North",6197,3043,3154,6192,5,57
"45UFGU","Roffey South",6096,2956,3140,5925,171,74
"45UFGW","Rudgwick",2791,1376,1415,2581,210,69
"45UFGX","Rusper and Colgate",2508,1252,1256,2261,247,50
"45UFGY","Southwater",10025,5031,4994,9263,762,114
"45UFGZ","Steyning",6038,2807,3231,5931,107,127
"45UFHA","Trafalgar",5863,2829,3034,5863,0,80
"45UGGH","Ardingly and Balcombe",5290,2629,2661,4882,408,113
"45UGGJ","Ashurst Wood",2784,1376,1408,2631,153,49
"45UGGK","Bolney",2614,1297,1317,2512,102,68
"45UGGL","Burgess Hill Dunstall",5184,2555,2629,5176,8,36
"45UGGM","Burgess Hill Franklands",4684,2243,2441,4476,208,113
"45UGGN","Burgess Hill Leylands",4759,2341,2418,4721,38,38
"45UGGP","Burgess Hill Meeds",4359,2054,2305,4320,39,34
"45UGGQ","Burgess Hill St Andrews",4505,2188,2317,4482,23,47
"45UGGR","Burgess Hill Victoria",5312,2600,2712,5258,54,32
"45UGGS","Copthorne and Worth",4580,2260,2320,4475,105,96
"45UGGT","Crawley Down and Turners Hill",7157,3663,3494,6772,385,126
"45UGGU","Cuckfield",4840,2372,2468,4730,110,137
"45UGGW","East Grinstead Ashplats",5105,2491,2614,5098,7,78
"45UGGX","East Grinstead Baldwins",4990,2378,2612,4882,108,70
"45UGGY","East Grinstead Herontye",4817,2367,2450,4713,104,109
"45UGGZ","East Grinstead Imberhorne",4026,1955,2071,4016,10,81
"45UGHA","East Grinstead Town",3991,1875,2116,3916,75,64
"45UGHB","Hassocks",6821,3163,3658,6748,73,107
"45UGHC","Haywards Heath Ashenground",5208,2538,2670,5183,25,69
"45UGHD","Haywards Heath Bentswood",5417,2579,2838,5417,0,46
"45UGHE","Haywards Heath Franklands",4311,2105,2206,4308,3,85
"45UGHF","Haywards Heath Heath",4630,2199,2431,4526,104,95
"45UGHG","Haywards Heath Lucastes",3234,1497,1737,3004,230,88
"45UGHH","High Weald",5108,2482,2626,4944,164,128
"45UGHJ","Hurstpierpoint and Downs",7094,3430,3664,6821,273,106
"45UGHK","Lindfield",6558,3071,3487,6415,143,163
"45UHFN","Broadwater",8475,3988,4487,8475,0,65
"45UHFP","Castle",7895,3790,4105,7895,0,49
"45UHFQ","Central",7467,3462,4005,7070,397,32
"45UHFR","Durrington",5519,2596,2923,5505,14,55
"45UHFS","Gaisford",8620,4136,4484,8557,63,76
"45UHFT","Goring",7803,3481,4322,7747,56,101
"45UHFU","Heene",7336,3282,4054,6333,1003,33
"45UHFW","Marine",7688,3497,4191,7532,156,95
"45UHFX","Northbrook",5041,2457,2584,5014,27,47
"45UHFY","Offington",7411,3550,3861,7383,28,102
"45UHFZ","Salvington",8561,4079,4482,8369,192,92
"45UHGA","Selden",7715,3634,4081,7274,441,57
"45UHGB","Tarring",8037,3812,4225,7899,138,69
"46UBGJ","Aldbourne",1782,873,909,1754,28,25
"46UBGK","All Cannings",1853,918,935,1853,0,71
"46UBGL","Bedwyn",1793,877,916,1767,26,32
"46UBGM","Bishops Cannings",1718,845,873,1718,0,50
"46UBGN","Bromham and Rowde",2880,1433,1447,2848,32,56
"46UBGP","Burbage",1660,804,856,1660,0,50
"46UBGQ","Cheverell",1980,1143,837,1666,314,34
"46UBGR","Collingbourne",1535,783,752,1528,7,30
"46UBGS","Devizes East",5138,2465,2673,5085,53,38
"46UBGT","Devizes North",3048,1429,1619,3037,11,44
"46UBGU","Devizes South",3110,1464,1646,3068,42,45
"46UBGW","Lavingtons",3538,1730,1808,3129,409,73
"46UBGX","Ludgershall",2946,1398,1548,2910,36,28
"46UBGY","Marlborough East",3640,1740,1900,3610,30,58
"46UBGZ","Marlborough West",4369,2218,2151,3396,973,101
"46UBHA","Milton Lilbourne",1492,748,744,1474,18,59
"46UBHB","Netheravon",1771,880,891,1771,0,34
"46UBHC","Ogbourne",1693,864,829,1654,39,52
"46UBHD","Pewsey",3237,1514,1723,3213,24,64
"46UBHE","Pewsey Vale",1597,764,833,1597,0,40
"46UBHF","Potterne",1570,774,796,1550,20,31
"46UBHG","Ramsbury",3257,1570,1687,3145,112,97
"46UBHH","Roundway",2267,1093,1174,2202,65,38
"46UBHJ","Seend",1450,723,727,1450,0,30
"46UBHK","Shalbourne",1759,879,880,1755,4,89
"46UBHL","Tidworth, Perham Down and Ludgershall South",8499,5001,3498,6812,1687,117
"46UBHM","Upavon",1982,1018,964,1905,77,89
"46UBHN","Urchfont",1690,799,891,1690,0,39
"46UBHP","West Selkley",1584,803,781,1570,14,72
"46UCGW","Ashton Keynes and Minety",4752,2387,2365,4706,46,127
"46UCGX","Box",4121,2041,2080,4038,83,107
"46UCGY","Bremhill",2195,1100,1095,2195,0,58
"46UCGZ","Brinkworth and The Somerfords",4356,2188,2168,4338,18,133
"46UCHA","Calne Abberd",2528,1212,1316,2528,0,26
"46UCHB","Calne Chilvester",1404,707,697,1404,0,13
"46UCHC","Calne Lickhill",2901,1296,1605,2619,282,25
"46UCHD","Calne Marden",2169,1041,1128,2146,23,16
"46UCHE","Calne Priestley",2605,1324,1281,2605,0,24
"46UCHF","Calne Quemerford",2182,1076,1106,2179,3,45
"46UCHG","Calne Without",1879,913,966,1817,62,31
"46UCHH","Cepen Park",5124,2587,2537,5086,38,57
"46UCHJ","Chippenham Allington",2554,1264,1290,2550,4,40
"46UCHK","Chippenham Audley",2627,1285,1342,2590,37,15
"46UCHL","Chippenham Avon",2404,1179,1225,2235,169,21
"46UCHM","Chippenham Hill Rise",2615,1252,1363,2581,34,35
"46UCHN","Chippenham London Road",2515,1172,1343,2462,53,13
"46UCHP","Chippenham Monkton Park",1997,979,1018,1949,48,22
"46UCHQ","Chippenham Park",2575,1299,1276,2564,11,29
"46UCHR","Chippenham Pewsham",5361,2741,2620,5351,10,36
"46UCHS","Chippenham Redland",2615,1289,1326,2593,22,18
"46UCHT","Chippenham Westcroft/Queen's",2802,1367,1435,2802,0,31
"46UCHU","Colerne",2807,1466,1341,2631,176,54
"46UCHW","Corsham",4633,2187,2446,4544,89,63
"46UCHX","Cricklade",4733,2387,2346,4683,50,92
"46UCHY","Hilmarton",2356,1147,1209,2326,30,73
"46UCHZ","Kington Langley",2066,1029,1037,2042,24,55
"46UCJA","Kington St. Michael",2047,967,1080,2029,18,36
"46UCJB","Lacock with Neston and Gastard",2753,1365,1388,2641,112,68
"46UCJC","Lyneham",5822,3142,2680,5091,731,80
"46UCJD","Malmesbury",4804,2383,2421,4727,77,45
"46UCJE","Nettleton",2431,1244,1187,2310,121,69
"46UCJF","Pickwick",3712,1772,1940,3710,3,41
"46UCJG","Purton",3983,1915,2068,3818,165,57
"46UCJH","St. Paul Malmesbury Without and Sherston",5259,2583,2676,5220,39,122
"46UCJJ","The Lydiards and Broad Town",2642,1318,1324,2634,8,48
"46UCJK","Wootton Bassett North",4888,2395,2493,4837,51,58
"46UCJL","Wootton Bassett South",6155,3028,3127,6119,36,95
"46UDGP","Alderbury and Whiteparish",5773,2832,2941,5741,32,132
"46UDGQ","Amesbury East",6812,3414,3398,6759,53,65
"46UDGR","Amesbury West",2095,1007,1088,1966,129,37
"46UDGS","Bemerton",6288,3042,3246,6283,5,34
"46UDGT","Bishopdown",3984,1900,2084,3974,10,41
"46UDGU","Bulford",5553,3173,2380,4586,967,85
"46UDGW","Chalke Valley",1922,926,996,1922,0,69
"46UDGX","Donhead",2247,1046,1201,1910,337,49
"46UDGY","Downton and Redlynch",5792,2796,2996,5712,80,125
"46UDGZ","Durrington",7182,3813,3369,6595,587,154
"46UDHA","Ebble",1919,885,1034,1716,203,61
"46UDHB","Fisherton and Bemerton Village",4333,2141,2192,4177,156,51
"46UDHC","Fonthill and Nadder",2093,1057,1036,2091,3,66
"46UDHD","Harnham East",3762,1821,1941,3718,44,75
"46UDHE","Harnham West",3551,1648,1903,3519,32,60
"46UDHF","Knoyle",2147,1036,1111,2112,35,83
"46UDHG","Laverstock",3488,1650,1838,3398,90,72
"46UDHH","Lower Wylye and Woodford Valley",2007,979,1028,1894,113,71
"46UDHJ","St Edmund and Milford",4622,2195,2427,4399,223,85
"46UDHK","St Mark and Stratford",6100,2910,3190,5988,112,168
"46UDHL","St Martin and Milford",4698,2029,2669,4268,430,71
"46UDHM","St Paul",3582,1798,1784,3581,3,22
"46UDHN","Till Valley and Wylye",4122,2039,2083,4058,64,94
"46UDHP","Tisbury and Fovant",3868,1853,2015,3849,19,112
"46UDHQ","Upper Bourne, Idmiston and Winterbourne",4478,2230,2248,4476,3,114
"46UDHR","Western and Mere",4154,1966,2188,4094,60,90
"46UDHS","Wilton",4426,2156,2270,4250,176,92
"46UDHT","Winterslow",3615,1778,1837,3610,5,84
"46UFGF","Atworth and Whitley",2596,1178,1418,2427,169,49
"46UFGG","Bradford-on-Avon North",4465,2127,2338,4450,15,87
"46UFGH","Bradford-on-Avon South",4861,2264,2597,4851,10,81
"46UFGJ","Dilton Marsh",5392,2690,2702,5364,28,92
"46UFGK","Ethandune",2553,1242,1311,2553,0,59
"46UFGL","Holt",2354,1154,1200,2301,53,44
"46UFGM","Manor Vale",4723,2243,2480,4563,160,110
"46UFGN","Melksham North",5718,2827,2891,5577,141,36
"46UFGP","Melksham Spa",5780,2816,2964,5730,50,57
"46UFGQ","Melksham Without",4910,2445,2465,4900,10,58
"46UFGR","Melksham Woodrow",2706,1344,1362,2706,0,14
"46UFGS","Mid Wylye Valley",2484,1229,1255,2461,23,85
"46UFGT","Paxcroft",5567,2714,2853,5532,35,55
"46UFGU","Shearwater",2546,1227,1319,2495,51,82
"46UFGW","Southwick and Wingfield",2194,1099,1095,2194,0,37
"46UFGX","Summerham",2188,1066,1122,2188,0,64
"46UFGY","Trowbridge Adcroft",5242,2585,2657,5149,93,46
"46UFGZ","Trowbridge College",5406,2659,2747,5394,12,40
"46UFHA","Trowbridge Drynham",6351,3107,3244,6318,33,49
"46UFHB","Trowbridge John of Gaunt",5295,2638,2657,5235,60,60
"46UFHC","Trowbridge Park",5946,2876,3070,5768,178,86
"46UFHD","Warminster East",8904,4476,4428,8374,530,144
"46UFHE","Warminster West",8473,4141,4332,8266,207,87
"46UFHF","Westbury Ham",6572,3159,3413,6480,92,42
"46UFHG","Westbury Laverton",4924,2390,2534,4876,48,41
"47UBFY","Alvechurch",6261,3016,3245,6168,93,72
"47UBFZ","Beacon",2145,1052,1093,2118,27,24
"47UBGA","Catshill",4428,2189,2239,4379,49,37
"47UBGB","Charford",5174,2521,2653,5174,0,24
"47UBGC","Drakes Cross and Walkers Heath",4838,2325,2513,4776,62,40
"47UBGD","Furlongs",4119,1992,2127,3917,202,77
"47UBGE","Hagley",4283,2022,2261,4260,23,109
"47UBGF","Hillside",4648,2263,2385,4545,103,84
"47UBGG","Hollywood and Majors Green",4279,2100,2179,4262,17,28
"47UBGH","Linthurst",2348,1127,1221,2250,98,65
"47UBGJ","Marlbrook",4217,2029,2188,4196,21,56
"47UBGK","Norton",4529,2300,2229,4459,70,35
"47UBGL","St Johns",4474,2062,2412,4124,350,49
"47UBGM","Sidemoor",4971,2423,2548,4902,69,48
"47UBGN","Slideslow",3468,1712,1756,3439,29,52
"47UBGP","Stoke Heath",2551,1319,1232,2551,0,49
"47UBGQ","Stoke Prior",2008,1014,994,2008,0,20
"47UBGR","Tardebigge",3044,1750,1294,2202,842,42
"47UBGS","Uffdown",2275,1131,1144,2214,61,28
"47UBGT","Waseley",4454,2228,2226,4449,5,20
"47UBGU","Whitford",5017,2447,2570,5004,13,67
"47UBGW","Woodvale",2046,1036,1010,2044,3,35
"47UBGX","Wythall South",2260,1083,1177,2241,19,32
"47UCHQ","Alfrick and Leigh",3289,1660,1629,3253,36,68
"47UCHR","Baldwin",1857,924,933,1783,74,41
"47UCHS","Broadheath",3267,1601,1666,3228,39,55
"47UCHT","Chase",6193,2823,3370,5710,483,93
"47UCHU","Dyson Perrins",3381,1694,1687,3381,0,42
"47UCHW","Hallow",1800,894,906,1800,0,34
"47UCHX","Kempsey",3736,1788,1948,3656,80,56
"47UCHY","Lindridge",1986,983,1003,1986,0,56
"47UCHZ","Link",5986,2820,3166,5892,94,70
"47UCJA","Longdon",2098,1050,1048,1941,157,45
"47UCJB","Martley",1604,780,824,1604,0,27
"47UCJC","Morton",1966,954,1012,1906,60,32
"47UCJD","Pickersleigh",6342,3037,3305,6306,36,57
"47UCJE","Powick",3757,1819,1938,3702,55,74
"47UCJF","Priory",3910,1898,2012,3147,763,68
"47UCJG","Ripple",1723,811,912,1699,24,24
"47UCJH","Teme Valley",1865,943,922,1865,0,42
"47UCJJ","Tenbury",3794,1840,1954,3667,127,54
"47UCJK","Upton and Hanley",4119,1996,2123,4067,52,64
"47UCJL","Wells",3219,1572,1647,3085,134,95
"47UCJM","West",4223,2101,2122,4118,105,62
"47UCJN","Woodbury",2057,1054,1003,1921,136,46
"47UDFM","Abbey",5259,2596,2663,5251,8,63
"47UDFN","Astwood Bank and Feckenham",5301,2627,2674,5267,34,93
"47UDFP","Batchley",6263,3006,3257,6135,128,20
"47UDFQ","Central",5455,2723,2732,5359,96,47
"47UDFR","Church Hill",8493,4196,4297,8493,0,54
"47UDFS","Crabbs Cross",5683,2824,2859,5675,8,65
"47UDFT","Greenlands",8411,4137,4274,8364,47,37
"47UDFU","Headless Cross and Oakenshaw",8692,4177,4515,8599,93,76
"47UDFW","Lodge Park",5125,2553,2572,5099,26,27
"47UDFX","Matchborough",6025,3006,3019,6015,10,43
"47UDFY","West",5461,2683,2778,5430,31,57
"47UDFZ","Winyates",8639,4300,4339,8603,36,60
"47UEFN","Arboretum",5611,2789,2822,5557,54,45
"47UEFP","Battenhall",5216,2556,2660,5018,198,79
"47UEFQ","Bedwardine",7875,3804,4071,7816,59,100
"47UEFR","Cathedral",7458,3781,3677,7309,149,78
"47UEFS","Claines",7873,3800,4073,7731,142,110
"47UEFT","Gorse Hill",5524,2670,2854,5521,3,22
"47UEFU","Nunnery",8011,3909,4102,7942,69,58
"47UEFW","Rainbow Hill",5845,2866,2979,5845,0,13
"47UEFX","St Clement",5493,2559,2934,4962,531,40
"47UEFY","St John",8033,3762,4271,8006,27,58
"47UEFZ","St Peter's Parish",5620,2738,2882,5617,3,48
"47UEGA","St Stephen",5047,2453,2594,5027,20,55
"47UEGB","Warndon",5292,2550,2742,5260,32,14
"47UEGC","Warndon Parish North",5231,2644,2587,5231,0,30
"47UEGD","Warndon Parish South",5224,2605,2619,5188,36,39
"47UFGP","Badsey",2657,1336,1321,2611,46,35
"47UFGQ","Bengeworth",4697,2342,2355,4652,45,34
"47UFGR","Bowbrook",2346,1179,1167,2346,0,53
"47UFGS","Bredon",2436,1195,1241,2436,0,52
"47UFGT","Bretforton and Offenham",2465,1210,1255,2453,12,37
"47UFGU","Broadway and Wickhamford",4458,2075,2383,4366,92,60
"47UFGW","Dodderhill",2099,1021,1078,1961,138,22
"47UFGX","Drakes Broughton",2410,1209,1201,2380,30,43
"47UFGY","Droitwich Central",2682,1316,1366,2639,43,23
"47UFGZ","Droitwich East",5099,2467,2632,4997,102,83
"47UFHA","Droitwich South East",4864,2450,2414,4848,16,113
"47UFHB","Droitwich South West",4980,2372,2608,4913,67,80
"47UFHC","Droitwich West",5253,2547,2706,5239,14,39
"47UFHD","Eckington",2553,1258,1295,2550,3,49
"47UFHE","Elmley Castle and Somerville",2473,1252,1221,2473,0,40
"47UFHF","Evesham North",4879,2370,2509,4835,44,31
"47UFHG","Evesham South",5004,2448,2556,4979,25,33
"47UFHH","Fladbury",2654,1293,1361,2592,62,60
"47UFHJ","Great Hampton",2498,1213,1285,2498,0,12
"47UFHK","Hartlebury",2549,1262,1287,2549,0,58
"47UFHL","Harvington and Norton",2621,1307,1314,2591,30,39
"47UFHM","Honeybourne and Pebworth",2443,1221,1222,2443,0,35
"47UFHN","Inkberrow",5308,2645,2663,5291,17,132
"47UFHP","Little Hampton",5226,2593,2633,5198,28,31
"47UFHQ","Lovett and North Claines",4994,2476,2518,4957,37,87
"47UFHR","Norton and Whittington",2884,1439,1445,2854,30,26
"47UFHS","Ombersley",2178,1096,1082,2175,3,36
"47UFHT","Pershore",7304,3499,3805,7246,58,80
"47UFHU","Pinvin",2841,1408,1433,2810,31,42
"47UFHW","South Bredon Hill",2306,1144,1162,2306,0,56
"47UFHX","The Littletons",3221,1835,1386,2773,448,30
"47UFHY","Upton Snodsbury",2575,1249,1326,2533,42,45
"47UGFU","Aggborough and Spennells",7225,3614,3611,7185,40,105
"47UGFW","Areley Kings",6041,2923,3118,6015,26,58
"47UGFX","Bewdley and Arley",6295,3080,3215,6219,76,101
"47UGFY","Blakedown and Chaddesley",4264,2236,2028,3969,295,94
"47UGFZ","Broadwaters",7787,3911,3876,7782,5,49
"47UGGA","Cookley",2491,1208,1283,2404,87,18
"47UGGB","Franche",7071,3452,3619,6991,80,38
"47UGGC","Greenhill",7293,3516,3777,7119,174,69
"47UGGD","Habberley and Blakebrook",6477,3124,3353,6345,132,53
"47UGGE","Lickhill",7131,3420,3711,7036,95,57
"47UGGF","Mitton",6541,3265,3276,6536,5,57
"47UGGG","Offmore and Comberton",6901,3307,3594,6809,92,85
"47UGGH","Oldington and Foley Park",5261,2622,2639,5242,19,27
"47UGGJ","Rock",2366,1171,1195,2355,11,37
"47UGGK","Sutton Park",7167,3556,3611,7069,98,48
"47UGGL","Wolverley",2096,1015,1081,2039,57,27
"47UGGM","Wribbenhall",4574,2243,2331,4495,79,68
